"","game_str","play_id","throw_time","Time_0","Time_1","throw_dist","Speed_init","pos_throw"
"1","1900_01_TeamKJ_TeamB",42,990,1364419,1365409,100.527273858586,107.918358834709,6
"2","1900_01_TeamKJ_TeamB",50,1089,1714042,1715131,101.23842332248,98.8325868993649,6
"3","1900_01_TeamKJ_TeamB",55,726,1825467,1826193,68.6885654521645,94.9524069811215,4
"4","1900_01_TeamKJ_TeamB",57,825,1878308,1879133,66.6744310827604,86.2594547336562,4
"5","1900_01_TeamKJ_TeamB",66,1023,2321633,2322656,104.622047616299,105.019753787748,5
"6","1900_01_TeamKJ_TeamB",80,1188,2823080,2824268,110.06838829418,96.6417920315928,6
"7","1900_01_TeamKJ_TeamB",86,1023,2942360,2943383,111.662206172069,113.13847214688,5
"8","1900_01_TeamKJ_TeamB",97,1221,3266536,3267757,130.342725973585,112.893891007983,5
"9","1900_01_TeamKJ_TeamB",124,726,4134241,4134967,60.6219984411202,82.736341704374,4
"10","1900_01_TeamKJ_TeamB",183,1089,6093490,6094579,113.883477913868,115.052357501389,5
"11","1900_01_TeamKJ_TeamB",239,1122,7891642,7892764,132.597069794686,124.880195322449,6
"12","1900_01_TeamKJ_TeamB",242,1188,8174133,8175321,118.044083901514,107.128482694373,6
"13","1900_01_TeamKJ_TeamB",251,1155,8416027,8417182,109.915699317948,105.866810864473,5
"14","1900_01_TeamKJ_TeamB",253,924,8577983,8578907,103.038769889762,112.209814231775,5
"15","1900_02_TeamKJ_TeamB",71,1023,2312350,2313373,89.1532513358105,91.9130072097002,5
"16","1900_02_TeamKJ_TeamB",276,1090,10541943,10543033,99.8969312719481,92.0793920730865,4
"17","1900_03_TeamKJ_TeamB",40,1221,1406295,1407516,117.354784192504,99.6214556510785,5
"18","1900_03_TeamKJ_TeamB",111,1023,4618418,4619441,99.811884096889,97.8576019661574,6
"19","1900_03_TeamKJ_TeamB",138,792,5666331,5667123,77.2824011046429,97.6690388982718,5
"20","1900_03_TeamKJ_TeamB",142,1287,5951396,5952683,109.568830110291,91.2487664481996,5
"21","1900_03_TeamKJ_TeamB",145,1155,6067574,6068729,114.01293524459,102.417716307011,5
"22","1900_03_TeamKJ_TeamB",147,924,6261017,6261941,66.8738882516937,69.336759914943,4
"23","1900_03_TeamKJ_TeamB",165,924,6824150,6825074,93.7027747874157,99.5425624174846,6
"24","1900_04_TeamKK_TeamB",15,726,431783,432509,69.6556921104088,95.5550284282035,4
"25","1900_04_TeamKK_TeamB",68,825,2171120,2171945,84.6694650824906,102.475570163714,6
"26","1900_04_TeamKK_TeamB",70,957,2243401,2244358,111.53526057886,121.690252664201,5
"27","1900_04_TeamKK_TeamB",128,1155,4459992,4461147,121.618483854019,111.876713237084,6
"28","1900_04_TeamKK_TeamB",195,1089,6771109,6772198,96.2085698484474,93.0413615434823,6
"29","1900_04_TeamKK_TeamB",206,924,7120600,7121524,100.290141293945,115.231005056734,5
"30","1900_04_TeamKK_TeamB",220,924,7655019,7655943,97.8923351584997,110.713846956629,6
"31","1900_04_TeamKK_TeamB",221,924,7689641,7690565,88.904285360497,99.93348698091,4
"32","1900_05_TeamKK_TeamB",61,1386,2467091,2468477,115.324751523823,86.1925460664633,4
"33","1900_05_TeamKK_TeamB",117,759,4392082,4392841,69.5762503599312,89.1996269956798,4
"34","1900_05_TeamKK_TeamB",160,792,6055968,6056760,67.3420891302751,84.0639518894577,4
"35","1900_05_TeamKK_TeamB",210,826,8064758,8065584,85.5512613230375,101.744265975206,5
"36","1900_06_TeamKL_TeamB",6,957,109063,110020,100.843032656115,112.838988751292,6
"37","1900_06_TeamKL_TeamB",59,825,1513398,1514223,75.4239312145622,93.7526825202621,4
"38","1900_06_TeamKL_TeamB",60,1056,1663802,1664858,101.045464027046,105.768909865192,6
"39","1900_06_TeamKL_TeamB",79,1056,2420543,2421599,84.2401680632419,87.8354569687049,4
"40","1900_06_TeamKL_TeamB",111,1452,3501197,3502649,149.628780518331,110.97552146696,6
"41","1900_06_TeamKL_TeamB",135,660,4594260,4594920,59.3429678867725,84.2731595157364,4
"42","1900_06_TeamKL_TeamB",144,990,4852458,4853448,79.1438785211849,85.2870804469198,4
"43","1900_06_TeamKL_TeamB",146,1089,5012434,5013523,109.693245695387,106.914691989932,6
"44","1900_06_TeamKL_TeamB",150,1354,5098148,5099502,125.59533827619,99.6344172567197,6
"45","1900_06_TeamKL_TeamB",152,1386,5145115,5146501,124.464433420571,94.0727969014909,6
"46","1900_06_TeamKL_TeamB",158,1057,5409419,5410476,109.249762512594,106.194279937875,6
"47","1900_06_TeamKL_TeamB",164,561,5578604,5579165,48.3899555720947,78.6534759094008,4
"48","1900_07_TeamKL_TeamB",8,1188,156937,158125,122.507345592311,114.426398474868,6
"49","1900_07_TeamKL_TeamB",11,891,209976,210867,105.225719837874,124.29399809612,6
"50","1900_07_TeamKL_TeamB",15,1188,404673,405861,113.075265140267,103.449946726875,6
"51","1900_07_TeamKL_TeamB",21,1155,516527,517682,98.4667437349535,101.123742960849,4
"52","1900_07_TeamKL_TeamB",83,1948,2367850,2369798,139.728212549625,86.2724801172565,6
"53","1900_07_TeamKL_TeamB",99,1023,2981283,2982306,115.93747874957,122.570504157788,6
"54","1900_07_TeamKL_TeamB",101,825,3028184,3029009,72.0016220924775,87.1785878117152,4
"55","1900_07_TeamKL_TeamB",131,726,4143294,4144020,68.1448730951765,91.6939366196912,4
"56","1900_07_TeamKL_TeamB",134,1023,4317330,4318353,102.278818499533,100.74763491084,5
"57","1900_07_TeamKL_TeamB",156,1320,5193912,5195232,138.233467996032,112.932705530304,5
"58","1900_07_TeamKL_TeamB",164,1585,5456401,5457986,145.427084979672,89.8668146546822,6
"59","1900_07_TeamKL_TeamB",185,1386,6462892,6464278,135.238816801372,109.936704829284,6
"60","1900_07_TeamKL_TeamB",187,694,6510287,6510981,60.9949419691806,90.7444262436476,4
"61","1900_08_TeamKL_TeamB",4,858,96057,96915,93.3309310576542,107.727590876298,4
"62","1900_08_TeamKL_TeamB",14,891,428155,429046,68.075655059194,104.023707409653,4
"63","1900_08_TeamKL_TeamB",52,792,1755026,1755818,96.7961702149307,124.427890063474,5
"64","1900_08_TeamKL_TeamB",58,660,2118644,2119304,62.915728794277,93.5079252277683,4
"65","1900_08_TeamKL_TeamB",82,1023,3108995,3110018,114.838622273737,116.431705017665,6
"66","1900_08_TeamKL_TeamB",115,627,4210673,4211300,73.0599403620299,114.528932332871,5
"67","1900_08_TeamKL_TeamB",130,990,4723968,4724958,101.447312699815,108.470896608671,5
"68","1900_08_TeamKL_TeamB",134,825,4823248,4824073,93.0920005097156,116.115510309998,5
"69","1900_08_TeamKL_TeamB",174,1122,6482051,6483173,107.296645405195,103.828956309384,6
"70","1900_08_TeamKL_TeamB",179,1221,6585126,6586347,127.063722994922,108.577539581561,5
"71","1900_08_TeamKL_TeamB",186,1056,6936168,6937224,94.9398323451513,89.7074166112951,5
"72","1900_08_TeamKL_TeamB",207,1254,7789713,7790967,121.725892278088,100.667607571576,6
"73","1900_08_TeamKL_TeamB",220,1254,8257990,8259244,124.314829244252,112.411941160177,6
"74","1900_08_TeamKL_TeamB",228,1089,8635304,8636393,118.18231713388,112.779693628111,5
"75","1900_08_TeamKL_TeamB",242,924,9164145,9165069,92.3937299564259,101.819074850726,4
"76","1900_08_TeamKL_TeamB",257,858,9784938,9785796,75.9374563768741,96.4142744846243,6
"77","1900_09_TeamKK_TeamB",11,1023,372955,373978,114.51796254101,118.201906772573,6
"78","1900_09_TeamKK_TeamB",35,1221,1158378,1159599,127.938514871234,109.808059432523,6
"79","1900_09_TeamKK_TeamB",58,924,1862575,1863499,86.4596558693261,93.1712370691129,4
"80","1900_09_TeamKK_TeamB",91,825,3299848,3300673,75.8118689802996,103.788986434043,5
"81","1900_09_TeamKK_TeamB",155,1221,5826191,5827412,131.495388984998,122.02109334777,6
"82","1900_09_TeamKK_TeamB",160,990,5971776,5972766,99.718714935182,104.177986634778,4
"83","1900_09_TeamKK_TeamB",170,726,6325558,6326284,70.6715695106472,99.0799037661562,4
"84","1900_09_TeamKK_TeamB",197,825,7498890,7499715,103.261245833104,131.905427679988,6
"85","1900_09_TeamKK_TeamB",228,1089,8951378,8952467,117.713847632621,119.278166066685,6
"86","1900_09_TeamKK_TeamB",242,693,9510518,9511211,62.4756953235318,164.338001191878,4
"87","1901_01_TeamLG_TeamA3",21,850,682726,683576,74.83180971936,84.3956677359344,6
"88","1901_01_TeamLG_TeamA3",26,1300,907276,908576,138.43046742807,115.38521109635,6
"89","1901_01_TeamLG_TeamA3",28,1100,958176,959276,88.3671634482415,83.8681970199798,4
"90","1901_01_TeamLG_TeamA3",43,1250,1562175,1563425,125.461369012983,109.74274550291,6
"91","1901_01_TeamLG_TeamA3",72,850,2385175,2386025,93.4983675661682,108.896130301741,6
"92","1901_01_TeamLG_TeamA3",103,1100,3388174,3389274,106.752626593255,102.723931310758,5
"93","1901_01_TeamLG_TeamA3",119,1100,3834523,3835623,127.0912331186,124.088156779183,5
"94","1901_01_TeamLG_TeamA3",176,950,5884371,5885321,100.14280588175,104.440503014016,6
"95","1901_01_TeamLG_TeamA3",223,1150,7347220,7348370,116.258720592964,109.443239522049,6
"96","1901_01_TeamLG_TeamA3",235,1400,7811931,7813331,149.797446018306,116.246523954386,5
"97","1901_01_TeamLG_TeamA3",241,900,7986731,7987631,66.2608149437916,75.1422482615189,4
"98","1901_02_TeamLG_TeamA3",33,900,978261,979161,92.9779093904917,110.700061877836,4
"99","1901_02_TeamLG_TeamA3",69,800,2218860,2219660,80.3458013121066,99.5589825177517,4
"100","1901_02_TeamLG_TeamA3",125,1250,5204295,5205545,115.457622309971,100.186213274295,5
"101","1901_02_TeamLG_TeamA3",229,950,8864442,8865392,85.9212941877004,91.4872784133518,6
"102","1901_02_TeamLG_TeamA3",236,1200,9199392,9200592,122.992553349432,110.436837871456,6
"103","1901_02_TeamLG_TeamA3",296,1300,11316490,11317790,134.229061835803,111.562849602225,6
"104","1901_03_TeamLG_TeamA3",21,1250,678429,679679,116.934734523804,99.3529580609519,5
"105","1901_03_TeamLG_TeamA3",88,1200,2934115,2935315,133.477774084537,118.979325957726,6
"106","1901_03_TeamLG_TeamA3",90,800,2980665,2981465,85.4362417123409,108.473200687542,5
"107","1901_03_TeamLG_TeamA3",96,850,3107115,3107965,102.311127965624,122.291447765779,6
"108","1901_03_TeamLG_TeamA3",122,1200,4357414,4358614,121.632345088878,106.38234978917,5
"109","1901_03_TeamLG_TeamA3",144,1450,5094313,5095763,140.179219069999,104.674391904024,5
"110","1901_03_TeamLG_TeamA3",147,1100,5282613,5283713,86.4646282054455,79.4361086271544,4
"111","1901_03_TeamLG_TeamA3",162,1250,5698112,5699362,112.936173969948,95.8000845973862,6
"112","1901_03_TeamLG_TeamA3",168,1350,5964862,5966212,131.480561130729,104.809108898467,6
"113","1901_03_TeamLG_TeamA3",171,1300,6024412,6025712,93.2636356967274,73.53891388529,4
"114","1901_03_TeamLG_TeamA3",176,1550,6172912,6174462,151.874081363163,107.96604375833,5
"115","1901_03_TeamLG_TeamA3",182,1050,6524012,6525062,115.83363954873,115.231232311742,6
"116","1901_03_TeamLG_TeamA3",205,1100,7682604,7683704,111.327977264752,104.575770353224,5
"117","1901_03_TeamLG_TeamA3",235,1450,8928603,8930053,132.287070066876,98.9183879797801,5
"118","1901_03_TeamLG_TeamA3",256,1100,9749852,9750952,115.125464561654,106.651998395049,6
"119","1901_04_TeamLI_TeamA3",71,1550,2189867,2191417,149.617161815207,107.602708869237,6
"120","1901_04_TeamLI_TeamA3",91,1450,2778066,2779516,154.869506512545,117.221104450842,6
"121","1901_04_TeamLI_TeamA3",142,1150,4485915,4487065,112.08370294256,98.377317659996,6
"122","1901_04_TeamLI_TeamA3",186,1000,6054413,6055413,95.9720681856627,95.3038791944072,6
"123","1901_04_TeamLI_TeamA3",196,850,6459213,6460063,72.9761027549814,90.2309415995042,4
"124","1901_04_TeamLI_TeamA3",237,750,7898061,7898811,73.8803220914054,101.487036225538,4
"125","1901_04_TeamLI_TeamA3",248,1100,8294561,8295661,110.007253972081,104.371402780698,4
"126","1901_04_TeamLI_TeamA3",259,1050,8780710,8781760,106.715184813858,104.668538205683,4
"127","1901_04_TeamLI_TeamA3",295,950,10021509,10022459,82.5680220329556,89.5048644986368,4
"128","1901_05_TeamLI_TeamA3",119,1000,4005702,4006702,100.146600882645,100.586799050626,5
"129","1901_05_TeamLI_TeamA3",162,1300,5588750,5590050,122.81492284777,102.690426829725,5
"130","1901_05_TeamLI_TeamA3",243,750,8268048,8268798,67.3931700340469,87.8610912740309,4
"131","1901_05_TeamLI_TeamA3",247,1000,8483647,8484647,70.7449424035795,71.0657834769655,4
"132","1901_05_TeamLI_TeamA3",250,1050,8562397,8563447,99.961114079049,99.2682985288322,6
"133","1901_05_TeamLI_TeamA3",295,1000,9943896,9944896,95.1434364771376,96.3785894287539,5
"134","1901_05_TeamLI_TeamA3",299,800,10091546,10092346,72.2941429828354,94.8434657504623,4
"135","1901_05_TeamLI_TeamA3",310,1000,10537845,10538845,80.960599857296,88.6802296425616,6
"136","1901_05_TeamLI_TeamA3",334,1400,11425595,11426995,128.645500222873,108.426819829364,6
"137","1901_06_TeamLI_TeamA3",18,1000,570684,571684,106.079417428206,108.375788558505,5
"138","1901_06_TeamLI_TeamA3",30,850,1006583,1007433,66.0823295246872,75.600438907494,4
"139","1901_06_TeamLI_TeamA3",46,1000,1448983,1449983,109.243758089989,110.342569638652,6
"140","1901_06_TeamLI_TeamA3",64,850,1973782,1974632,85.8763087148408,102.232363314571,6
"141","1901_06_TeamLI_TeamA3",71,700,2252982,2253682,59.7993177424239,92.4583841991935,4
"142","1901_06_TeamLI_TeamA3",84,750,2721932,2722682,70.0171343777245,101.356647671443,4
"143","1901_06_TeamLI_TeamA3",87,900,2893781,2894681,103.297434808633,116.572563705848,6
"144","1901_06_TeamLI_TeamA3",131,1200,4592980,4594180,108.709230175685,92.1720533953514,5
"145","1901_06_TeamLI_TeamA3",154,700,5393579,5394279,80.6607834671309,113.585559773442,6
"146","1901_06_TeamLI_TeamA3",161,1150,5682729,5683879,97.4456876264841,88.5657943032285,6
"147","1901_06_TeamLI_TeamA3",196,1150,7068627,7069777,116.700009441878,106.891378920927,5
"148","1901_06_TeamLI_TeamA3",215,650,7731927,7732577,44.9436295238206,77.0193718898152,4
"149","1901_06_TeamLI_TeamA3",216,700,7832027,7832727,62.780209885128,95.4766084014731,4
"150","1901_06_TeamLI_TeamA3",238,1000,8747176,8748176,102.54279995449,111.989958847803,6
"151","1901_07_TeamLK_TeamB",6,1150,119454,120604,106.290049846339,103.978665405238,6
"152","1901_07_TeamLK_TeamB",24,750,817403,818153,69.3870863451863,97.795104098702,4
"153","1901_07_TeamLK_TeamB",38,1250,1209103,1210353,119.883126185156,108.175929298685,6
"154","1901_07_TeamLK_TeamB",53,1000,1679453,1680453,111.040117562625,116.378280170946,5
"155","1901_07_TeamLK_TeamB",54,1050,1717703,1718753,85.0536974680334,87.7980180394801,4
"156","1901_07_TeamLK_TeamB",66,1250,2240402,2241652,122.267150938294,111.603051152997,5
"157","1901_07_TeamLK_TeamB",125,950,4368200,4369150,91.8637500723219,109.450938016292,5
"158","1901_07_TeamLK_TeamB",164,1200,5985598,5986798,120.110786884822,110.111303206653,5
"159","1901_07_TeamLK_TeamB",182,1000,6644498,6645498,110.366448091158,116.140420466855,5
"160","1901_07_TeamLK_TeamB",194,1600,7167597,7169197,147.752320973798,103.004956714049,6
"161","1901_07_TeamLK_TeamB",214,1350,7877447,7878797,114.814474835979,94.2310556482911,5
"162","1901_07_TeamLK_TeamB",230,950,8600846,8601796,94.2907830709096,105.573657318025,5
"163","1901_07_TeamLK_TeamB",249,900,9382095,9382995,76.7046765084572,94.6616537337968,4
"164","1901_08_TeamLK_TeamB",40,800,1249842,1250642,83.7048704843727,108.403721723858,4
"165","1901_08_TeamLK_TeamB",62,1250,1880192,1881442,121.103309382314,109.674471581351,6
"166","1901_08_TeamLK_TeamB",84,750,2802941,2803691,57.1993582755684,76.5446370201806,4
"167","1901_08_TeamLK_TeamB",111,1050,3585790,3586840,104.743800208567,104.137841132426,6
"168","1901_08_TeamLK_TeamB",117,900,3869340,3870240,104.124912542201,126.933296706284,6
"169","1901_08_TeamLK_TeamB",139,1200,4691639,4692839,111.609169079581,95.9367896105738,6
"170","1901_08_TeamLK_TeamB",143,950,4911439,4912389,81.9765435949881,85.429129385093,4
"171","1901_08_TeamLK_TeamB",158,1000,5456888,5457888,87.122301012219,98.4498866213673,6
"172","1901_08_TeamLK_TeamB",184,1300,6574237,6575537,127.140253645175,104.616266355088,5
"173","1901_08_TeamLK_TeamB",193,1000,6960887,6961887,117.361182780946,122.622203653764,5
"174","1901_08_TeamLK_TeamB",248,1150,9219035,9220185,124.566105985983,117.262942763548,6
"175","1901_09_TeamLK_TeamB",11,950,527682,528632,114.006568263764,123.823265072927,6
"176","1901_09_TeamLK_TeamB",12,700,567532,568232,71.9093751175549,103.972742816462,6
"177","1901_09_TeamLK_TeamB",19,1450,827382,828832,123.804801183445,118.000496860466,6
"178","1901_09_TeamLK_TeamB",38,1350,1317331,1318681,127.008145821772,100.34595426579,6
"179","1901_09_TeamLK_TeamB",42,1900,1526181,1528081,143.77602165968,88.7809123055268,6
"180","1901_09_TeamLK_TeamB",53,850,2162283,2163133,94.1773850983899,111.240093019504,6
"181","1901_09_TeamLK_TeamB",78,1100,2876383,2877483,116.242594836361,117.552493409509,6
"182","1901_09_TeamLK_TeamB",96,1050,3686632,3687682,109.824188031157,104.801553376166,6
"183","1901_09_TeamLK_TeamB",160,1900,6062580,6064480,117.058725856895,77.0156249027208,4
"184","1901_09_TeamLK_TeamB",193,700,7364628,7365328,67.5945122752931,93.3161518879909,4
"185","1901_09_TeamLK_TeamB",205,1300,7777328,7778628,128.627413853232,114.099589019373,5
"186","1901_09_TeamLK_TeamB",207,900,7826078,7826978,103.632697270168,116.17131309929,6
"187","1901_10_TeamLJ_TeamB",10,700,431166,431866,74.4527702313083,107.287830005215,6
"188","1901_10_TeamLJ_TeamB",29,850,1095915,1096765,94.3868674043924,116.722061675015,6
"189","1901_10_TeamLJ_TeamB",37,1000,1374465,1375465,75.0943010515644,80.5297825061987,4
"190","1901_10_TeamLJ_TeamB",84,700,3059464,3060164,66.958186412932,91.7696966883227,4
"191","1901_10_TeamLJ_TeamB",87,1000,3257413,3258413,106.615172921239,116.457470956762,6
"192","1901_10_TeamLJ_TeamB",93,1000,3376263,3377263,113.506169559233,127.830375924799,6
"193","1901_10_TeamLJ_TeamB",132,1200,5069362,5070562,109.884805229225,95.1249432840253,4
"194","1901_10_TeamLJ_TeamB",176,900,7037410,7038310,73.8628330809372,81.8734377320688,6
"195","1901_10_TeamLJ_TeamB",181,850,7368909,7369759,63.9814939170566,83.0844297481004,4
"196","1901_10_TeamLJ_TeamB",185,800,7621459,7622259,63.1454157353533,78.166746053396,4
"197","1901_10_TeamLJ_TeamB",192,1450,7982359,7983809,134.587136129343,100.827760845582,6
"198","1901_10_TeamLJ_TeamB",197,1100,8107909,8109009,124.781120757105,126.519538337638,6
"199","1901_10_TeamLJ_TeamB",214,1100,8958558,8959658,103.666317938475,95.7748726151389,4
"200","1901_10_TeamLJ_TeamB",216,750,9134608,9135358,81.7427795650266,117.980826347782,4
"201","1901_10_TeamLJ_TeamB",249,750,10227207,10227957,63.8900284499937,90.590836184439,4
"202","1901_11_TeamLJ_TeamB",71,850,2314244,2315094,80.8270146150253,103.111662039145,5
"203","1901_11_TeamLJ_TeamB",146,950,5355141,5356091,103.472626486825,115.646341853415,6
"204","1901_11_TeamLJ_TeamB",153,850,5723591,5724441,75.7419874404348,88.6526420795924,4
"205","1901_11_TeamLJ_TeamB",154,1000,5767341,5768341,90.3094907143272,101.950924350586,6
"206","1901_11_TeamLJ_TeamB",164,900,6226740,6227640,94.586511011042,110.02338331013,4
"207","1901_11_TeamLJ_TeamB",189,900,7095339,7096239,90.4132005429299,100.307569746256,5
"208","1901_11_TeamLJ_TeamB",193,900,7245239,7246139,78.9105930341359,85.8531618899353,6
"209","1901_11_TeamLJ_TeamB",204,1150,7701639,7702789,119.363211699614,110.574003654293,5
"210","1901_11_TeamLJ_TeamB",220,950,8476988,8477938,100.390409536602,115.17219215693,6
"211","1901_11_TeamLJ_TeamB",250,1250,9468487,9469737,114.250695180159,100.999627882485,5
"212","1901_11_TeamLJ_TeamB",282,950,10822136,10823086,95.2683660702452,109.003304131293,6
"213","1901_11_TeamLJ_TeamB",296,650,11422135,11422785,70.4148378959589,105.491610552627,6
"214","1901_12_TeamLJ_TeamB",58,1400,2050595,2051995,139.721507944221,109.237234212287,5
"215","1901_12_TeamLJ_TeamB",83,1250,2774394,2775644,135.141608507401,116.055163232373,6
"216","1901_12_TeamLJ_TeamB",139,900,4810342,4811242,62.5186889754753,59.4331422692761,4
"217","1901_12_TeamLJ_TeamB",215,1350,7404890,7406240,120.320418450424,99.7695403255357,5
"218","1901_12_TeamLJ_TeamB",252,1250,8651739,8652989,118.122162400395,103.154600812173,5
"219","1901_12_TeamLJ_TeamB",263,1000,9125938,9126938,94.2822450029247,100.148027102783,6
"220","1901_12_TeamLJ_TeamB",268,800,9245338,9246138,68.8462799222444,90.5836979867954,4
"221","1901_12_TeamLJ_TeamB",269,950,9284888,9285838,76.5484549961022,92.3353464348019,4
"222","1901_13_TeamLL_TeamB",5,950,114125,115075,56.8767532818778,61.9387341270572,4
"223","1901_13_TeamLL_TeamB",69,1000,2134574,2135574,103.470186165351,114.096966757175,5
"224","1901_13_TeamLL_TeamB",132,800,4052472,4053272,72.2731871562093,96.2088366790397,6
"225","1901_13_TeamLL_TeamB",136,1200,4245022,4246222,116.426405193827,110.97364725756,5
"226","1901_13_TeamLL_TeamB",140,1100,4340921,4342021,120.045821100195,120.028528590723,6
"227","1901_13_TeamLL_TeamB",183,1100,6136720,6137820,102.771886606561,108.119129770527,4
"228","1901_13_TeamLL_TeamB",193,900,6479869,6480769,76.6709484050103,94.7415379902581,4
"229","1901_13_TeamLL_TeamB",195,1100,6692019,6693119,110.907334128758,107.696474641852,5
"230","1901_13_TeamLL_TeamB",204,850,6902369,6903219,70.1401838110594,86.2262934568438,4
"231","1901_13_TeamLL_TeamB",233,1050,8048418,8049468,114.85470015238,122.571081728877,6
"232","1901_14_TeamLL_TeamB",22,1000,795401,796401,87.1766796925082,95.3909749063748,4
"233","1901_14_TeamLL_TeamB",85,900,2949799,2950699,95.7776780438612,111.675168385035,5
"234","1901_14_TeamLL_TeamB",105,950,3636698,3637648,80.5495423337403,98.9912194487588,4
"235","1901_14_TeamLL_TeamB",199,1150,7342145,7343295,135.888170548555,126.012131005963,5
"236","1901_14_TeamLL_TeamB",254,950,9219393,9220343,113.377334677849,132.943233284283,5
"237","1901_15_TeamLL_TeamB",2,900,18271,19171,95.0823640821238,109.746526751585,4
"238","1901_15_TeamLL_TeamB",14,1200,324121,325321,127.540678866666,120.11102314882,6
"239","1901_15_TeamLL_TeamB",38,850,1259920,1260770,77.1550088023188,98.4617788658597,4
"240","1901_15_TeamLL_TeamB",91,850,3011469,3012319,53.7537279300351,64.0258488073876,4
"241","1901_15_TeamLL_TeamB",137,1450,4672117,4673567,114.306659571267,76.3590250791614,6
"242","1901_15_TeamLL_TeamB",172,1700,6025816,6027516,91.6788200180869,58.7912409833235,6
"243","1901_15_TeamLL_TeamB",213,1100,7765514,7766614,91.0911844999676,79.0983676112221,4
"244","1901_15_TeamLL_TeamB",223,1050,8072414,8073464,107.447022499168,120.444471200872,5
"245","1901_15_TeamLL_TeamB",232,1250,8430263,8431513,91.0517577283205,83.8969135298651,6
"246","1901_15_TeamLL_TeamB",248,950,9206163,9207113,74.9575865138835,96.0974706542814,4
"247","1901_16_TeamLH_TeamA3",117,600,4046723,4047323,46.9922846044127,77.2905148862765,4
"248","1901_16_TeamLH_TeamA3",118,1350,4089323,4090673,136.20665092867,111.248194869806,6
"249","1901_16_TeamLH_TeamA3",211,1150,7387970,7389120,132.911952000485,119.497381243992,5
"250","1901_16_TeamLH_TeamA3",214,550,7456420,7456970,43.3765630098975,73.4318223526228,4
"251","1901_17_TeamLH_TeamA3",12,1050,323844,324894,101.11449904997,99.7484874799309,5
"252","1901_17_TeamLH_TeamA3",50,700,1471339,1472039,51.2545169781482,75.9420472998929,4
"253","1901_17_TeamLH_TeamA3",61,1050,1831488,1832538,92.1189366831403,91.3697913432932,6
"254","1901_17_TeamLH_TeamA3",112,1200,3608137,3609337,103.997464777929,91.195204229472,6
"255","1901_17_TeamLH_TeamA3",140,1000,4533236,4534236,103.059675813176,107.103684702823,6
"256","1901_17_TeamLH_TeamA3",163,800,5239885,5240685,47.1386146495744,52.2557672908749,4
"257","1901_17_TeamLH_TeamA3",174,850,5661935,5662785,77.4688388544287,90.0648736302735,6
"258","1901_17_TeamLH_TeamA3",188,1300,6442834,6444134,107.046693714448,91.4806251146868,6
"259","1901_17_TeamLH_TeamA3",260,1100,9063331,9064431,120.901761203153,117.94126034577,5
"260","1901_17_TeamLH_TeamA3",283,1300,9877981,9879281,107.897148436038,91.5373581004734,6
"261","1901_17_TeamLH_TeamA3",330,750,11594279,11595029,54.3148491992159,81.6787928854061,4
"262","1901_17_TeamLH_TeamA3",340,700,12083978,12084678,56.8615678880374,83.0073561523394,4
"263","1901_18_TeamLH_TeamA3",30,1000,1056552,1057552,98.8492459207235,110.469858341662,6
"264","1901_18_TeamLH_TeamA3",32,1150,1103102,1104252,108.383314729578,100.797560957026,5
"265","1901_18_TeamLH_TeamA3",252,900,8603745,8604645,104.411854585708,127.574532763499,6
"266","1901_18_TeamLH_TeamA3",255,800,8799845,8800645,68.0561466651177,85.3531192258906,4
"267","1901_18_TeamLH_TeamA3",275,950,9569794,9570744,83.5173493938705,95.3111116709382,4
"268","1902_01_TeamMG_TeamA3",15,1150,352243,353393,104.051206454557,91.1837700079469,4
"269","1902_01_TeamMG_TeamA3",64,1050,1967493,1968543,112.919240618036,108.412141587464,6
"270","1902_01_TeamMG_TeamA3",169,900,5283193,5284093,97.3629414944934,109.235275697017,6
"271","1902_01_TeamMG_TeamA3",189,700,5974543,5975243,54.8481359776745,71.571927604994,4
"272","1902_02_TeamMG_TeamA3",68,750,2184519,2185269,66.33075936459,89.8675403843878,4
"273","1902_02_TeamMG_TeamA3",79,1000,2566269,2567269,103.661902304105,108.517211117592,6
"274","1902_02_TeamMG_TeamA3",161,1350,5581519,5582869,123.458152624021,96.1573971919011,6
"275","1902_02_TeamMG_TeamA3",185,750,6358919,6359669,63.5359344221419,91.1329828381475,4
"276","1902_02_TeamMG_TeamA3",249,1050,8590019,8591069,112.718788830328,112.110920396186,5
"277","1902_02_TeamMG_TeamA3",296,1100,10143119,10144219,88.3801159411443,81.0845246499819,4
"278","1902_02_TeamMG_TeamA3",302,800,10309519,10310319,77.4996377939549,91.5885469923812,4
"279","1902_02_TeamMG_TeamA3",337,900,11516519,11517419,91.0106853230229,105.2725452226,5
"280","1902_02_TeamMG_TeamA3",341,800,11642119,11642919,54.1884770638403,67.4887006322096,4
"281","1902_02_TeamMG_TeamA3",354,900,12109419,12110319,76.427100179869,83.6214776777165,4
"282","1902_02_TeamMG_TeamA3",356,850,12279569,12280419,74.3695910216872,85.8944054340576,4
"283","1902_02_TeamMG_TeamA3",358,1150,12326819,12327969,105.265484551857,94.6835735890234,5
"284","1902_03_TeamMG_TeamA3",15,1200,473196,474396,104.781736022895,85.614631253442,4
"285","1902_03_TeamMG_TeamA3",16,1000,625696,626696,103.059595814785,106.186809252651,6
"286","1902_03_TeamMG_TeamA3",24,800,803896,804696,87.2271492441161,107.095807588333,5
"287","1902_03_TeamMG_TeamA3",53,1000,1788796,1789796,110.042949414438,118.01235946879,5
"288","1902_03_TeamMG_TeamA3",99,750,3189146,3189896,75.1588806751464,102.868130130033,5
"289","1902_03_TeamMG_TeamA3",102,1100,3268496,3269596,125.680629782191,119.380170869993,5
"290","1902_03_TeamMG_TeamA3",106,1150,3477246,3478396,117.204588158629,102.170942272756,6
"291","1902_03_TeamMG_TeamA3",122,1000,3957596,3958596,106.464949493218,107.529654803782,6
"292","1902_03_TeamMG_TeamA3",126,900,4141346,4142246,96.9160877755896,111.283587822291,5
"293","1902_03_TeamMG_TeamA3",137,1150,4454496,4455646,81.2665149579493,72.7785575951554,4
"294","1902_03_TeamMG_TeamA3",200,750,7143546,7144296,61.5888461835858,81.5788484225014,4
"295","1902_03_TeamMG_TeamA3",230,900,8070496,8071396,74.6309263031309,79.061086339512,4
"296","1902_03_TeamMG_TeamA3",321,800,11555796,11556596,73.6089085673298,88.6712031579347,4
"297","1902_04_TeamML_TeamB",15,850,397634,398484,86.5880605622457,108.675369112169,4
"298","1902_04_TeamML_TeamB",39,900,977334,978234,71.3513757122572,78.9240916701483,4
"299","1902_04_TeamML_TeamB",40,800,1116934,1117734,81.4795983501727,101.873650892625,6
"300","1902_04_TeamML_TeamB",43,950,1176334,1177284,93.9481235902733,103.686627138586,5
"301","1902_04_TeamML_TeamB",53,900,1445034,1445934,97.1536674441569,114.840216688393,5
"302","1902_04_TeamML_TeamB",93,800,2822834,2823634,90.6269383883538,124.24711874924,5
"303","1902_04_TeamML_TeamB",104,700,3275084,3275784,68.33881804941,97.5420328460911,6
"304","1902_04_TeamML_TeamB",109,950,3378884,3379834,101.753955011675,109.331291704885,6
"305","1902_04_TeamML_TeamB",110,900,3526134,3527034,97.8094175596017,117.592060664447,5
"306","1902_04_TeamML_TeamB",135,950,4331084,4332034,109.614595068898,120.95275403966,6
"307","1902_04_TeamML_TeamB",140,1050,4449184,4450234,110.484763384266,113.589130547547,6
"308","1902_04_TeamML_TeamB",158,850,5183834,5184684,91.079288112545,107.220249597667,6
"309","1902_04_TeamML_TeamB",165,1250,5317034,5318284,116.837115017457,106.031422547136,4
"310","1902_04_TeamML_TeamB",192,1100,6102634,6103734,105.477242607077,104.173020360029,5
"311","1902_04_TeamML_TeamB",205,1000,6775884,6776884,103.68163509889,110.327955027264,6
"312","1902_05_TeamML_TeamB",143,1000,12244629,12245629,107.249306096007,112.575884020764,6
"313","1902_05_TeamML_TeamB",145,950,12451229,12452179,63.1835309938633,71.5879538048303,4
"314","1902_05_TeamML_TeamB",206,1300,14563779,14565079,127.481687832437,106.402592587133,6
"315","1902_05_TeamML_TeamB",214,1100,14789829,14790929,102.545152266879,101.984810174968,4
"316","1902_05_TeamML_TeamB",220,1150,15103029,15104179,116.777038318646,108.889665110556,5
"317","1902_05_TeamML_TeamB",276,1050,17237729,17238779,88.3492891469837,87.4446298056102,4
"318","1902_06_TeamML_TeamB",22,1050,693653,694703,120.198069332553,120.695460061074,5
"319","1902_06_TeamML_TeamB",32,1350,987953,989303,125.799044177482,100.740729668739,6
"320","1902_06_TeamML_TeamB",45,1450,1375403,1376853,121.632501307388,78.8813506355137,4
"321","1902_06_TeamML_TeamB",118,750,4153024,4153774,53.7350464956678,75.8742712394338,4
"322","1902_06_TeamML_TeamB",125,1100,4408974,4410074,87.8788778210594,83.4225250125176,4
"323","1902_06_TeamML_TeamB",191,850,6541474,6542324,82.9169119005972,101.119314537042,4
"324","1902_06_TeamML_TeamB",267,1000,9493874,9494874,111.674486657024,117.954552628594,6
"325","1902_06_TeamML_TeamB",288,1200,10217674,10218874,117.693979533027,103.494363522973,6
"326","1902_07_TeamMJ_TeamB",76,750,2601252,2602002,58.2372388340438,79.8635297880694,4
"327","1902_07_TeamMJ_TeamB",85,800,3004802,3005602,70.1081278627584,91.1043114557014,4
"328","1902_07_TeamMJ_TeamB",93,900,3300352,3301252,87.7417989308777,104.6677327877,4
"329","1902_07_TeamMJ_TeamB",129,750,4572052,4572802,72.24212094668,86.2231285101354,6
"330","1902_07_TeamMJ_TeamB",136,700,4906102,4906802,61.4646757344202,90.967322833587,4
"331","1902_07_TeamMJ_TeamB",166,900,5969802,5970702,33.0288539680609,23.8102049822288,4
"332","1902_07_TeamMJ_TeamB",176,850,6377552,6378402,87.0276409446102,111.046269984477,4
"333","1902_07_TeamMJ_TeamB",180,600,6473802,6474402,39.1666802002439,70.7939319206271,4
"334","1902_07_TeamMJ_TeamB",195,850,7057002,7057852,89.8526865932922,110.850320198966,6
"335","1902_07_TeamMJ_TeamB",232,750,8588502,8589252,66.038824082318,91.4111537007813,4
"336","1902_07_TeamMJ_TeamB",237,1350,8732202,8733552,141.292120337812,113.464618460749,6
"337","1902_07_TeamMJ_TeamB",252,750,9307202,9307952,66.867050898857,93.581126544031,6
"338","1902_07_TeamMJ_TeamB",281,750,10569302,10570052,59.0299302200593,85.3575042714265,4
"339","1902_07_TeamMJ_TeamB",288,1300,10852752,10854052,135.368678102781,112.284849897275,5
"340","1902_08_TeamMJ_TeamB",108,1050,3961744,3962794,101.189782080899,100.358988560993,6
"341","1902_08_TeamMJ_TeamB",123,1200,4409494,4410694,126.592376307562,113.449635519623,5
"342","1902_08_TeamMJ_TeamB",133,950,4873894,4874844,93.1910612941211,97.454284858582,4
"343","1902_08_TeamMJ_TeamB",160,800,6311044,6311844,65.934614559132,72.6100382826887,4
"344","1902_08_TeamMJ_TeamB",164,1350,6413694,6415044,122.861625230753,99.874392744557,5
"345","1902_08_TeamMJ_TeamB",227,1100,8700644,8701744,108.418131512851,102.221917537275,6
"346","1902_08_TeamMJ_TeamB",230,800,8777494,8778294,71.7149357345853,94.5237939349369,4
"347","1902_08_TeamMJ_TeamB",316,850,12222555,12223405,74.76236050862,64.5836684435801,4
"348","1902_08_TeamMJ_TeamB",318,1100,12282055,12283155,113.227009462557,108.03848473149,6
"349","1902_08_TeamMJ_TeamB",321,1000,12363005,12364005,96.5960837043494,104.874203318234,6
"350","1902_08_TeamMJ_TeamB",357,1700,13678455,13680155,151.058438848764,96.3134726778441,6
"351","1902_09_TeamMJ_TeamB",1,900,18405,19305,90.4361127202495,103.477918123567,5
"352","1902_09_TeamMJ_TeamB",10,950,356305,357255,89.1268483930244,94.0193405627571,4
"353","1902_09_TeamMJ_TeamB",23,1000,795255,796255,96.8728790220053,97.8611730857312,4
"354","1902_09_TeamMJ_TeamB",36,900,1147555,1148455,87.7110379769309,101.156614248874,6
"355","1902_09_TeamMJ_TeamB",184,1050,6885705,6886755,121.638688453547,122.345595115508,5
"356","1902_09_TeamMJ_TeamB",282,1000,10703055,10704055,92.883485187909,90.7747784161325,4
"357","1902_09_TeamMJ_TeamB",304,950,11433255,11434205,80.7212154481614,87.6743595274828,4
"358","1902_09_TeamMJ_TeamB",312,1100,11665855,11666955,111.027535762524,105.544424024674,6
"359","1902_10_TeamMI_TeamA3",114,600,3943731,3944331,62.6395548228084,105.767562719669,6
"360","1902_10_TeamMI_TeamA3",176,1100,6332881,6333981,124.153761577481,116.635947553805,5
"361","1902_10_TeamMI_TeamA3",229,1150,8382081,8383231,126.600460488402,120.424420306723,5
"362","1902_10_TeamMI_TeamA3",258,900,9488281,9489181,102.378358962528,115.957264122414,6
"363","1902_10_TeamMI_TeamA3",268,1350,9873681,9875031,137.598280698484,109.757994512141,6
"364","1902_10_TeamMI_TeamA3",282,1050,10361281,10362331,106.107291165753,107.234764712875,6
"365","1902_11_TeamMI_TeamA3",11,1150,219402,220552,113.341286796742,100.289782496743,4
"366","1902_11_TeamMI_TeamA3",70,950,2445902,2446852,91.8140771774181,96.7110586548002,6
"367","1902_11_TeamMI_TeamA3",73,750,2510252,2511002,65.7495348259238,89.9579083982343,4
"368","1902_11_TeamMI_TeamA3",144,1050,4744752,4745802,107.12522770991,106.692354538698,6
"369","1902_11_TeamMI_TeamA3",175,750,5787902,5788652,56.2740772333695,71.148161805459,4
"370","1902_11_TeamMI_TeamA3",187,1050,6240752,6241802,112.922040883816,120.822349824957,6
"371","1902_11_TeamMI_TeamA3",212,950,7181452,7182402,89.1107735101915,96.5624517280929,4
"372","1902_11_TeamMI_TeamA3",267,1300,9469002,9470302,131.694286732481,110.924666116947,6
"373","1902_12_TeamMI_TeamA3",13,800,303604,304404,79.0817279043599,101.530759173029,6
"374","1902_12_TeamMI_TeamA3",71,900,2387854,2388754,89.9168874133896,100.329648228872,4
"375","1902_12_TeamMI_TeamA3",138,950,4693304,4694254,100.027887492478,109.078425918174,6
"376","1902_12_TeamMI_TeamA3",174,1200,6079654,6080854,131.417256700053,119.891003128368,5
"377","1902_12_TeamMI_TeamA3",196,900,7126154,7127054,89.7200390169635,101.270508230197,5
"378","1902_12_TeamMI_TeamA3",208,850,7444004,7444854,80.2085899951685,87.2347402372836,4
"379","1902_12_TeamMI_TeamA3",225,1150,7937854,7939004,128.269726580019,119.284690654868,6
"380","1902_12_TeamMI_TeamA3",240,1200,8745704,8746904,119.048774409331,105.056367043396,4
"381","1902_12_TeamMI_TeamA3",260,800,9359354,9360154,80.564393102966,103.833649062639,6
"382","1902_12_TeamMI_TeamA3",266,1300,9670804,9672104,114.681957012653,95.5012902444261,5
"383","1902_13_TeamMD_TeamA2",17,1000,615280,616280,84.0749120638639,90.329346251588,4
"384","1902_13_TeamMD_TeamA2",20,800,759080,759880,78.6081237476598,98.3853906573756,4
"385","1902_13_TeamMD_TeamA2",44,850,1678830,1679680,83.2954448278566,101.115166785707,6
"386","1902_13_TeamMD_TeamA2",58,650,2130930,2131580,29.3585689404098,41.4517179401945,4
"387","1902_13_TeamMD_TeamA2",88,1000,3241080,3242080,100.923210990454,106.144835883603,5
"388","1902_13_TeamMD_TeamA2",91,800,3323230,3324030,62.7079396161354,78.2052484078302,4
"389","1902_13_TeamMD_TeamA2",108,950,3928030,3928980,98.1773670841901,111.529265733672,5
"390","1902_13_TeamMD_TeamA2",248,1200,8691530,8692730,122.124341525888,106.48026640289,6
"391","1902_13_TeamMD_TeamA2",264,1050,9061880,9062930,103.494728042324,103.180100841305,6
"392","1902_13_TeamMD_TeamA2",318,1150,11168580,11169730,118.096513703292,106.067180965191,6
"393","1902_13_TeamMK_TeamB",4,1250,73010,74260,108.534567641699,90.9185984445676,4
"394","1902_13_TeamMK_TeamB",92,1150,3415760,3416910,98.9803519906658,84.306673932181,6
"395","1902_13_TeamMK_TeamB",108,700,3892160,3892860,71.2463917597916,98.0417469487367,4
"396","1902_13_TeamMK_TeamB",112,1200,4011110,4012310,127.045902332443,112.837107003984,6
"397","1902_13_TeamMK_TeamB",130,1100,4619310,4620410,109.665091731936,105.821078761288,5
"398","1902_13_TeamMK_TeamB",240,1250,9037410,9038660,125.21885919981,105.865699303037,6
"399","1902_13_TeamMK_TeamB",282,800,10494210,10495010,68.8496616801549,93.6263885810201,4
"400","1902_13_TeamMK_TeamB",288,1200,10669910,10671110,103.280463072037,93.6172960060652,6
"401","1902_14_TeamMD_TeamA2",2,900,42497,43397,80.317492825888,90.7699916444432,4
"402","1902_14_TeamMD_TeamA2",27,850,848147,848997,76.0453124965617,88.3522286377586,4
"403","1902_14_TeamMD_TeamA2",66,1450,2199776,2201226,144.888259383512,109.638425503154,6
"404","1902_14_TeamMD_TeamA2",110,1100,3516676,3517776,74.8125401993152,73.1709499035769,4
"405","1902_14_TeamMD_TeamA2",121,1250,3950376,3951626,123.426408422281,106.838812794858,5
"406","1902_14_TeamMD_TeamA2",173,950,5602926,5603876,92.2852928548785,100.846968432213,4
"407","1902_14_TeamMD_TeamA2",192,900,6377678,6378578,46.5542725232598,49.488708435289,4
"408","1902_14_TeamMD_TeamA2",199,1050,6689328,6690378,74.2748891284598,73.7777093054456,4
"409","1902_14_TeamMD_TeamA2",245,850,8473465,8474315,86.0809009522281,106.479921708552,6
"410","1902_14_TeamMD_TeamA2",247,1100,8531265,8532365,118.40444427294,109.86059548406,5
"411","1902_14_TeamMD_TeamA2",280,1050,9729215,9730265,102.247977595449,103.371097486077,5
"412","1902_14_TeamMD_TeamA2",284,700,9839465,9840165,46.4521414646556,62.7913196521741,4
"413","1902_14_TeamMD_TeamA2",314,900,10904015,10904915,79.774037491803,92.3251305906819,4
"414","1902_14_TeamMD_TeamA2",327,1150,11391415,11392565,111.021784117886,99.6363586516076,6
"415","1902_14_TeamMK_TeamB",9,950,200085,201035,110.229998350586,119.324346100722,6
"416","1902_14_TeamMK_TeamB",26,1150,845085,846235,107.605251480686,97.5199476985853,6
"417","1902_14_TeamMK_TeamB",104,850,3325035,3325885,77.209716324207,94.8520186512353,4
"418","1902_14_TeamMK_TeamB",113,750,3626485,3627235,59.9689051052383,77.5133006322826,4
"419","1902_14_TeamMK_TeamB",118,1400,3757135,3758535,125.85946251396,95.2357739092091,6
"420","1902_14_TeamMK_TeamB",160,1150,5156785,5157935,121.865150534652,112.903426870528,6
"421","1902_14_TeamMK_TeamB",298,1350,9802085,9803435,135.263267272242,108.460968594786,5
"422","1902_15_TeamMK_TeamB",24,750,781614,782364,57.2202231672214,75.9541725969493,4
"423","1902_15_TeamMK_TeamB",40,1100,1208764,1209864,119.842037011561,116.838626853469,5
"424","1902_15_TeamMK_TeamB",53,800,1545564,1546364,68.9991958209949,94.808742016249,4
"425","1902_15_TeamMK_TeamB",93,1050,3027264,3028314,74.2619054484309,65.1222373572192,4
"426","1902_15_TeamMK_TeamB",99,950,3220314,3221264,90.2355511185671,97.5212908558674,5
"427","1902_15_TeamMK_TeamB",127,1400,4212914,4214314,134.348895685604,106.178377361865,5
"428","1902_15_TeamMK_TeamB",183,850,6144514,6145364,75.9342977868186,80.9594665551858,4
"429","1902_15_TeamMK_TeamB",191,800,6488664,6489464,66.875643907256,85.9758643840857,4
"430","1902_15_TeamMK_TeamB",209,1000,7207964,7208964,101.101876801567,107.33820988757,6
"431","1902_15_TeamMK_TeamB",257,750,8904364,8905114,65.2001002307869,91.5066002653852,4
"432","1902_15_TeamMK_TeamB",261,800,9172514,9173314,71.2326931917689,97.4689350802869,4
"433","1902_16_TeamMD_TeamA2",24,850,678206,679056,71.1948130080522,85.7797758761934,4
"434","1902_16_TeamMD_TeamA2",77,950,2526717,2527667,103.772140544784,116.292964305255,6
"435","1902_16_TeamMD_TeamA2",83,850,2836851,2837701,72.0161432606553,90.3180109185177,4
"436","1902_16_TeamMD_TeamA2",84,1250,2870351,2871601,132.583503000807,116.316036834184,6
"437","1902_16_TeamMD_TeamA2",90,1200,3123001,3124201,116.182899144262,106.62298253712,6
"438","1902_16_TeamMD_TeamA2",112,1250,3867766,3869016,138.6648411985,120.839809829068,6
"439","1902_16_TeamMD_TeamA2",127,850,4432416,4433266,76.1737634286355,94.1867237307921,4
"440","1902_16_TeamMD_TeamA2",131,1200,4537016,4538216,105.74790616472,94.9708896654198,5
"441","1902_16_TeamMD_TeamA2",146,950,4925616,4926566,92.5757946911133,109.821316057366,4
"442","1902_16_TeamMD_TeamA2",149,1100,5101116,5102216,120.512306661977,118.078182047241,5
"443","1902_16_TeamMD_TeamA2",179,850,6038466,6039316,88.1274266609804,108.178841821936,4
"444","1902_16_TeamMD_TeamA2",189,1100,6445616,6446716,95.2287497325294,92.0614916654034,6
"445","1902_16_TeamMD_TeamA2",205,1050,7180766,7181816,112.909637997454,115.448062233789,5
"446","1902_16_TeamMD_TeamA2",237,1100,8241666,8242766,126.268750413583,116.162547550902,5
"447","1902_16_TeamMD_TeamA2",244,850,8489066,8489916,88.5908493819203,109.859142701719,5
"448","1902_16_TeamMD_TeamA2",265,600,9134516,9135116,60.640680504879,94.2655489582909,4
"449","1902_17_TeamMB_TeamA1",2,800,55984,56784,81.902185582833,102.917201535507,4
"450","1902_17_TeamMB_TeamA1",9,800,196934,197734,60.6049058246357,75.4678652634712,4
"451","1902_17_TeamMB_TeamA1",38,750,1312234,1312984,58.4778478291337,75.6548851259898,4
"452","1902_17_TeamMB_TeamA1",54,1350,1779534,1780884,121.577304258835,97.6785983109125,5
"453","1902_17_TeamMB_TeamA1",56,950,1837884,1838834,98.2552241427124,105.985908722049,6
"454","1902_17_TeamMB_TeamA1",57,1000,1881284,1882284,105.109259970672,107.797476940157,6
"455","1902_17_TeamMB_TeamA1",59,700,2045284,2045984,67.4317726649045,93.6852918507494,4
"456","1902_17_TeamMB_TeamA1",80,800,2705634,2706434,75.8174598893013,91.3538065091354,4
"457","1902_17_TeamMB_TeamA1",99,650,3422220,3422870,59.2506513639693,92.869788633637,4
"458","1902_17_TeamMB_TeamA1",102,850,3613070,3613920,59.9245756111397,68.1277416261397,6
"459","1902_17_TeamMB_TeamA1",103,1100,3641120,3642220,118.911235548294,112.853649670641,6
"460","1902_17_TeamMB_TeamA1",123,1300,4553468,4554768,121.765702218077,98.5878717974833,6
"461","1902_17_TeamMB_TeamA1",129,850,4683218,4684068,90.216673843325,107.865622794157,6
"462","1902_17_TeamMB_TeamA1",202,1050,7115132,7116182,89.4062793769312,88.5775819811619,4
"463","1902_17_TeamMB_TeamA1",246,800,8515632,8516432,69.1661370800745,86.6586048607543,4
"464","1902_18_TeamMB_TeamA1",28,1150,845604,846754,116.109199807299,103.70421106228,6
"465","1902_18_TeamMB_TeamA1",31,1650,951704,953354,106.416242319979,86.4893886291504,4
"466","1902_18_TeamMB_TeamA1",48,750,1543304,1544054,76.0847898430224,98.7135527877655,4
"467","1902_18_TeamMB_TeamA1",75,1250,2720754,2722004,115.771859977523,98.98482789725,6
"468","1902_18_TeamMB_TeamA1",86,950,2946704,2947654,100.727860855683,107.451776718869,5
"469","1902_18_TeamMB_TeamA1",96,950,3465854,3466804,106.278894609738,115.053242448331,6
"470","1902_18_TeamMB_TeamA1",112,800,3951504,3952304,65.5810681147248,78.2464283812112,4
"471","1902_18_TeamMB_TeamA1",146,700,5215454,5216154,73.1159939406063,102.502248725347,4
"472","1902_18_TeamMB_TeamA1",158,1050,5742454,5743504,104.423199295206,102.717878126451,6
"473","1902_18_TeamMB_TeamA1",190,1150,6860754,6861904,120.843535997947,113.142335662115,5
"474","1902_18_TeamMB_TeamA1",193,750,7113304,7114054,86.8769065038204,113.266875414177,5
"475","1902_19_TeamME_TeamA2",23,1200,535237,536437,127.40913551832,113.6367285388,5
"476","1902_19_TeamME_TeamA2",24,1150,744002,745152,129.711561571986,120.853184298956,6
"477","1902_19_TeamME_TeamA2",62,950,2299352,2300302,96.1507762542137,103.795721449898,4
"478","1902_19_TeamME_TeamA2",154,1250,5367852,5369102,133.607434390612,114.560481815657,6
"479","1902_19_TeamME_TeamA2",161,1250,5538052,5539302,135.619902951936,117.370021502385,5
"480","1902_19_TeamME_TeamA2",182,850,6480302,6481152,84.5682096364867,102.163743230072,6
"481","1902_19_TeamME_TeamA2",213,850,7575352,7576202,78.7682241723525,96.3476221179795,4
"482","1902_19_TeamME_TeamA2",235,950,8278052,8279002,81.0042963628819,88.3614558024076,4
"483","1902_19_TeamME_TeamA2",243,700,8575102,8575802,70.5693509847946,103.873999122724,4
"484","1902_19_TeamME_TeamA2",261,750,9285252,9286002,77.0057286725452,100.027364670379,4
"485","1902_19_TeamME_TeamA2",280,600,9926652,9927252,52.9296360750258,83.3959682965855,4
"486","1902_20_TeamME_TeamA2",8,1050,199028,200078,106.902701433024,107.019434132958,6
"487","1902_20_TeamME_TeamA2",34,950,1151028,1151978,95.8253630044868,101.592515223383,6
"488","1902_20_TeamME_TeamA2",53,900,1833578,1834478,93.5896425443127,104.747426043655,5
"489","1902_20_TeamME_TeamA2",95,750,3252278,3253028,69.9229234404888,96.2645391309114,4
"490","1902_20_TeamME_TeamA2",105,900,3749278,3750178,81.6326749224563,91.0237906798447,4
"491","1902_20_TeamME_TeamA2",124,900,4386678,4387578,94.5464776122262,110.558416324333,5
"492","1902_20_TeamME_TeamA2",129,950,4611428,4612378,75.6629632618045,80.9328797410144,4
"493","1902_20_TeamME_TeamA2",141,800,5010478,5011278,66.9510877932801,85.8972437022422,4
"494","1902_20_TeamME_TeamA2",171,750,6309778,6310528,64.6365844454755,89.1501123398661,4
"495","1902_20_TeamME_TeamA2",193,900,7095028,7095928,97.8644238639952,112.918375357142,6
"496","1902_20_TeamME_TeamA2",198,600,7235378,7235978,62.1230260708165,105.616299897148,6
"497","1902_20_TeamME_TeamA2",232,1150,8861178,8862328,121.863925327914,113.095599335013,5
"498","1902_21_TeamME_TeamA2",4,1500,54658,56158,151.725689835742,115.857361786847,6
"499","1902_21_TeamME_TeamA2",21,750,634658,635408,65.4366762303132,90.1784823893697,4
"500","1902_21_TeamME_TeamA2",33,1350,905608,906958,130.025041020068,100.870136868855,6
"501","1902_21_TeamME_TeamA2",76,800,2688058,2688858,68.7454022574961,84.1633472328667,4
"502","1902_21_TeamME_TeamA2",86,900,3093108,3094008,88.3677672578473,96.648838509895,6
"503","1902_21_TeamME_TeamA2",99,1000,3611358,3612358,82.0122135710908,83.3111127115064,4
"504","1902_21_TeamME_TeamA2",111,650,4021558,4022208,50.5854967025479,78.5494722244028,6
"505","1902_21_TeamME_TeamA2",141,600,4888608,4889208,47.6119534229978,74.6091426756339,4
"506","1902_21_TeamME_TeamA2",143,1050,5065458,5066508,114.009500898759,114.277350283206,5
"507","1902_21_TeamME_TeamA2",174,800,6307208,6308008,50.9996075186144,66.7407746902088,4
"508","1902_21_TeamME_TeamA2",187,1050,6925458,6926508,105.874905559384,104.90034364183,5
"509","1902_22_TeamMA_TeamA1",75,900,2639040,2639940,83.1732312032512,88.4018474018429,4
"510","1902_22_TeamMA_TeamA1",84,1050,3054840,3055890,89.7663760012143,86.4645186316503,6
"511","1902_22_TeamMA_TeamA1",104,850,3682640,3683490,75.2863784821332,90.3506623861331,4
"512","1902_22_TeamMA_TeamA1",155,750,5521240,5521990,74.5297396799667,104.825698821467,4
"513","1902_22_TeamMA_TeamA1",157,1150,5681840,5682990,114.389144218305,105.235023725963,5
"514","1902_22_TeamMA_TeamA1",161,900,5781190,5782090,38.5061774818813,39.8586338211308,4
"515","1902_22_TeamMA_TeamA1",164,750,5860240,5860990,68.9322072246387,89.2038941236614,6
"516","1902_22_TeamMA_TeamA1",182,800,6392290,6393090,92.6226108974407,113.526679991677,6
"517","1902_22_TeamMA_TeamA1",193,1350,6794440,6795790,121.700431266804,100.630844574711,6
"518","1902_22_TeamMA_TeamA1",195,950,6841540,6842490,95.0745361050951,102.781586581604,5
"519","1902_22_TeamMA_TeamA1",249,800,8903940,8904740,73.6518847168391,92.6412542457421,4
"520","1902_23_TeamMA_TeamA1",3,600,43088,43688,43.5608603048223,68.0899265425617,4
"521","1902_23_TeamMA_TeamA1",6,750,106138,106888,66.6188771550509,91.3567309539811,4
"522","1902_23_TeamMA_TeamA1",31,950,884288,885238,91.1291137140745,99.7549864191089,6
"523","1902_23_TeamMA_TeamA1",39,1000,1213138,1214138,91.0739512512963,95.4529416475167,6
"524","1902_23_TeamMA_TeamA1",130,650,4378388,4379038,67.2467213987423,103.910910027804,4
"525","1902_23_TeamMA_TeamA1",152,850,5081488,5082338,72.7010282141746,88.1236191077261,6
"526","1902_23_TeamMA_TeamA1",221,900,7740138,7741038,90.5202414373409,100.026318861768,4
"527","1902_23_TeamMA_TeamA1",222,800,8083838,8084638,75.9292528327427,97.7427844621375,4
"528","1902_23_TeamMA_TeamA1",255,950,9314738,9315688,88.8406268181531,98.7701869972575,4
"529","1902_24_TeamMA_TeamA1",10,1287,262376,263663,114.450005014629,94.6582166871387,5
"530","1902_24_TeamMA_TeamA1",14,990,384839,385829,83.1129899808892,87.3082948991801,4
"531","1902_24_TeamMA_TeamA1",27,1122,780443,781565,130.809455274139,126.303567347291,6
"532","1902_24_TeamMA_TeamA1",58,1023,1815621,1816644,109.727611914577,112.277390495806,6
"533","1902_24_TeamMA_TeamA1",65,594,1981677,1982271,42.2273360757386,67.1311918143041,4
"534","1902_24_TeamMA_TeamA1",74,759,2318971,2319730,62.3827254565843,81.0257353702825,4
"535","1902_24_TeamMA_TeamA1",76,759,2367382,2368141,58.3257372413305,76.0040488832737,4
"536","1902_24_TeamMA_TeamA1",85,1056,2600956,2602012,108.794493776768,105.44400283216,5
"537","1902_24_TeamMA_TeamA1",141,1452,4737894,4739346,142.95148144917,107.974653789124,6
"538","1902_24_TeamMA_TeamA1",234,858,8048952,8049810,91.1728200616004,112.165427212425,5
"539","1902_24_TeamMA_TeamA1",240,1221,8243124,8244345,115.903548694446,102.922922667041,6
"540","1902_24_TeamMA_TeamA1",278,924,9527387,9528311,106.248137704804,121.949902776091,6
"541","1902_24_TeamMA_TeamA1",283,1221,9764624,9765845,119.508743025345,105.160788928919,5
"542","1902_24_TeamMA_TeamA1",284,1485,9800891,9802376,133.535746086747,98.3056391679788,6
"543","1902_24_TeamMA_TeamA1",327,1287,11474124,11475411,129.59480401899,107.373805113639,6
"544","1902_25_TeamMH_TeamA3",79,750,2444212,2444962,82.4521284589541,114.993858541806,5
"545","1902_25_TeamMH_TeamA3",87,1000,2606462,2607462,111.105514273378,114.374449699655,5
"546","1902_25_TeamMH_TeamA3",122,650,3893762,3894412,58.1911977968304,88.3419340930172,4
"547","1902_25_TeamMH_TeamA3",126,1400,3990362,3991762,142.925124932512,116.718159718858,5
"548","1902_25_TeamMH_TeamA3",151,950,4895062,4896012,90.9365777212715,97.287745821966,4
"549","1902_25_TeamMH_TeamA3",157,1200,5042112,5043312,118.847455569899,105.268682914072,6
"550","1902_25_TeamMH_TeamA3",169,1100,5465212,5466312,117.801365525286,110.747854767509,5
"551","1902_25_TeamMH_TeamA3",322,2250,10475397,10477647,150.731676858296,75.9822926221483,6
"552","1902_26_TeamMC_TeamA1",8,1050,606877,607927,100.215519323947,100.230156354374,6
"553","1902_26_TeamMC_TeamA1",48,950,1883177,1884127,95.326121445893,105.286488735905,4
"554","1902_26_TeamMC_TeamA1",56,1000,2079077,2080077,108.106703525089,109.144331307209,6
"555","1902_26_TeamMC_TeamA1",115,1050,4017827,4018877,102.676602037561,99.2269371620391,5
"556","1902_26_TeamMC_TeamA1",120,1550,4221977,4223527,132.94326755961,92.0522970814478,6
"557","1902_26_TeamMC_TeamA1",188,700,6550577,6551277,34.1756546992297,49.6224103294977,4
"558","1902_26_TeamMC_TeamA1",199,850,7013977,7014827,89.8375489684467,114.379622719309,6
"559","1902_26_TeamMC_TeamA1",204,1050,7286127,7287177,110.227693244152,115.236103143651,5
"560","1902_26_TeamMC_TeamA1",230,1100,8074727,8075827,123.978846537324,122.3257571866,5
"561","1902_26_TeamMC_TeamA1",254,1100,8977927,8979027,97.5760778615355,95.9055373847552,5
"562","1902_26_TeamMH_TeamA3",4,1100,70306,71406,133.560229816517,126.723348426806,5
"563","1902_26_TeamMH_TeamA3",99,950,3115556,3116506,96.5099994540679,105.101360632484,5
"564","1902_26_TeamMH_TeamA3",111,1100,3510006,3511106,106.065217903908,100.357620292123,6
"565","1902_26_TeamMH_TeamA3",130,1800,4130356,4132156,134.117278477061,86.1678012599787,4
"566","1902_26_TeamMH_TeamA3",156,1100,5066706,5067806,122.465749344258,118.953043270991,5
"567","1902_26_TeamMH_TeamA3",166,1050,5461656,5462706,88.9800915804992,83.8910190086843,4
"568","1902_26_TeamMH_TeamA3",202,1300,6691506,6692806,132.770096922471,108.911729923429,6
"569","1902_26_TeamMH_TeamA3",254,800,8672008,8672808,83.6344071261917,98.9785795560821,6
"570","1902_26_TeamMH_TeamA3",260,1150,8855108,8856258,121.964368651192,118.4011716494,6
"571","1902_26_TeamMH_TeamA3",291,1200,9973158,9974358,98.1727583166442,77.7438058885261,4
"572","1902_26_TeamMH_TeamA3",297,800,10129858,10130658,66.1055869102099,82.5439246930063,4
"573","1902_27_TeamMH_TeamA3",57,900,1857072,1857972,80.3173759362025,77.6485261387575,4
"574","1902_27_TeamMH_TeamA3",191,1100,6675872,6676972,111.455375561597,112.237723518221,5
"575","1902_27_TeamMH_TeamA3",265,1250,8907522,8908772,118.794140365811,101.321546311823,5
"576","1902_27_TeamMH_TeamA3",282,750,9567272,9568022,67.708653032011,90.4540859239724,4
"577","1902_28_TeamMC_TeamA1",16,950,620705,621655,96.1665339645353,110.701423197467,5
"578","1902_28_TeamMC_TeamA1",28,1050,1005955,1007005,81.7631451366153,80.412960192625,4
"579","1902_28_TeamMC_TeamA1",44,850,1651405,1652255,55.7380438837232,65.6214494036715,4
"580","1902_28_TeamMC_TeamA1",57,900,2086005,2086905,58.3960300224554,63.0421527866098,4
"581","1902_28_TeamMC_TeamA1",71,1150,2531655,2532805,53.5689812554212,49.6039171489166,4
"582","1902_28_TeamMC_TeamA1",149,550,5551255,5551805,36.2459369180645,62.2885741438478,4
"583","1902_28_TeamMC_TeamA1",167,1450,6140205,6141655,112.294190731387,86.4233198042734,4
"584","1902_28_TeamMC_TeamA1",179,1300,6608355,6609655,134.307595162469,114.040259789655,5
"585","1902_28_TeamMC_TeamA1",192,900,7084555,7085455,69.2631964546947,79.2359317269052,4
"586","1902_29_TeamMF_TeamA2",5,900,114268,115168,91.6996955392062,106.604909543354,6
"587","1902_29_TeamMF_TeamA2",15,900,513468,514368,102.360107490282,119.788712277729,5
"588","1902_29_TeamMF_TeamA2",20,900,641668,642568,81.8505798990346,91.8370033010991,4
"589","1902_29_TeamMF_TeamA2",24,1000,851818,852818,96.8749056115407,101.276360849868,4
"590","1902_29_TeamMF_TeamA2",30,800,974368,975168,83.830879903724,104.530365542468,4
"591","1902_29_TeamMF_TeamA2",47,800,1572418,1573218,65.8766011412649,79.510684092053,4
"592","1902_29_TeamMF_TeamA2",95,1550,3779460,3781010,140.551600463259,96.6637888908115,6
"593","1902_29_TeamMF_TeamA2",132,850,5301060,5301910,83.7855340789561,102.834851248301,6
"594","1902_29_TeamMF_TeamA2",136,1300,5395610,5396910,129.171488782063,108.949346213905,5
"595","1902_29_TeamMF_TeamA2",159,1150,6254310,6255460,117.785402710891,108.892379266356,5
"596","1902_29_TeamMF_TeamA2",160,900,6288260,6289160,83.710381239088,97.5318926262557,4
"597","1902_29_TeamMF_TeamA2",222,1150,8668310,8669460,125.114622723626,115.944778532173,5
"598","1902_30_TeamMF_TeamA2",20,1050,476000,477050,107.406349823944,106.350896184632,5
"599","1902_30_TeamMF_TeamA2",29,1600,907654,909254,136.64725697836,100.360940447501,6
"600","1902_30_TeamMF_TeamA2",37,1050,1189954,1191004,94.6887213917573,95.6657352336075,4
"601","1902_30_TeamMF_TeamA2",150,550,4863579,4864129,56.0069867601311,105.739633642769,4
"602","1902_30_TeamMF_TeamA2",155,950,5213579,5214529,96.0989518009474,103.219232123701,4
"603","1902_30_TeamMF_TeamA2",178,650,6066329,6066979,46.5483477744309,73.1577061624086,4
"604","1902_30_TeamMF_TeamA2",194,750,6723779,6724529,85.0963225768852,117.664065477326,5
"605","1902_30_TeamMF_TeamA2",227,1350,7854379,7855729,116.528776427893,93.406088737886,6
"606","1902_30_TeamMF_TeamA2",248,1100,8590979,8592079,101.814155862338,104.408756281812,6
"607","1902_30_TeamMF_TeamA2",273,600,9497429,9498029,52.9699922310783,85.0901121840067,4
"608","1902_30_TeamMF_TeamA2",320,900,11419014,11419914,76.0689797462249,84.7890267179091,4
"609","1902_31_TeamMF_TeamA2",19,1200,521546,522746,130.349887891607,115.631734178393,5
"610","1902_31_TeamMF_TeamA2",35,950,977596,978546,97.082436603941,106.373056343333,4
"611","1902_31_TeamMF_TeamA2",66,1000,1861796,1862796,98.549610899216,101.885991159169,6
"612","1902_31_TeamMF_TeamA2",71,800,1965246,1966046,38.7130770851902,46.6445414701826,4
"613","1902_31_TeamMF_TeamA2",188,850,5960746,5961596,78.9072741178181,95.737026885166,6
"614","1902_31_TeamMF_TeamA2",203,900,6461596,6462496,67.0128840750557,76.2770579071333,4
"615","1902_31_TeamMF_TeamA2",245,1150,7943646,7944796,119.385783525686,108.758698045107,6
"616","1902_31_TeamMF_TeamA2",287,1300,9338796,9340096,138.135069669617,112.555175752991,6
"617","1903_01_TeamNE_TeamA2",18,924,461301,462225,100.210016071194,111.100565023846,6
"618","1903_01_TeamNE_TeamA2",38,1023,1094175,1095198,118.174253460441,125.036533397361,5
"619","1903_01_TeamNE_TeamA2",58,1122,1618117,1619239,114.651170161299,107.61267213595,6
"620","1903_01_TeamNE_TeamA2",117,1122,3639039,3640161,103.503975982785,102.31304281624,6
"621","1903_01_TeamNE_TeamA2",119,1089,3795327,3796416,115.364361373446,110.719875581039,6
"622","1903_01_TeamNE_TeamA2",185,693,6121268,6121961,63.6492658247197,93.1296538549113,4
"623","1903_01_TeamNE_TeamA2",260,891,8668772,8669663,95.8207219855076,112.956949274484,4
"624","1903_01_TeamNE_TeamA2",326,990,10932706,10933696,105.416901342691,110.32536812233,5
"625","1903_02_TeamNE_TeamA2",42,850,1203525,1204375,81.199142280418,92.8674301699447,4
"626","1903_02_TeamNE_TeamA2",46,650,1410325,1410975,65.2368608920527,98.9921681358206,6
"627","1903_02_TeamNE_TeamA2",49,1050,1492975,1494025,111.697015024798,109.650443520649,5
"628","1903_02_TeamNE_TeamA2",55,950,1694175,1695125,96.5352024150828,104.68127386281,5
"629","1903_02_TeamNE_TeamA2",62,1050,2164841,2165891,120.704768053541,117.968197175507,6
"630","1903_02_TeamNE_TeamA2",72,900,3222287,3223187,92.1998788380481,104.6747834568,6
"631","1903_02_TeamNE_TeamA2",96,1100,4105237,4106337,114.8720009546,108.101825127325,6
"632","1903_02_TeamNE_TeamA2",138,950,5685537,5686487,101.91594004673,111.987183982704,6
"633","1903_02_TeamNE_TeamA2",141,800,5757087,5757887,73.0916177349241,91.1809218293456,4
"634","1903_02_TeamNE_TeamA2",147,650,5908887,5909537,55.9103567116147,82.3821302822916,4
"635","1903_02_TeamNE_TeamA2",151,1050,6074837,6075887,100.073927335816,101.780879603341,5
"636","1903_02_TeamNE_TeamA2",152,1000,6105737,6106737,110.905169705979,114.754036661227,6
"637","1903_02_TeamNE_TeamA2",168,900,6557387,6558287,91.3111775558846,106.485221619658,5
"638","1903_02_TeamNE_TeamA2",171,1000,6761137,6762137,106.99517659275,109.695970075914,5
"639","1903_02_TeamNE_TeamA2",194,1150,7423137,7424287,102.666568721441,93.3254256728044,6
"640","1903_03_TeamNE_TeamA2",36,900,986528,987428,93.2984204828045,104.217529252332,6
"641","1903_03_TeamNE_TeamA2",52,1100,1382178,1383278,114.826017069253,110.692842570988,6
"642","1903_03_TeamNE_TeamA2",55,900,1433928,1434828,63.6374956512916,70.8451959978644,4
"643","1903_03_TeamNE_TeamA2",62,800,1730478,1731278,87.9206892258193,111.14310128178,4
"644","1903_03_TeamNE_TeamA2",90,1000,2605278,2606278,94.4283997902927,100.611864344941,5
"645","1903_03_TeamNE_TeamA2",96,1150,2733478,2734628,126.062735190943,119.100882381108,6
"646","1903_03_TeamNE_TeamA2",128,1150,3631678,3632828,111.45731566343,106.465199029465,5
"647","1903_03_TeamNE_TeamA2",148,950,4336028,4336978,79.0525804887642,85.3094395997324,4
"648","1903_03_TeamNE_TeamA2",166,1050,5038778,5039828,110.484390469153,111.573313407004,6
"649","1903_03_TeamNE_TeamA2",173,950,5190528,5191478,107.249250845194,115.426193967508,5
"650","1903_03_TeamNE_TeamA2",176,750,5364728,5365478,67.0525697692147,93.7377380928373,4
"651","1903_03_TeamNE_TeamA2",214,1150,6774728,6775878,127.679003648523,118.754661709022,5
"652","1903_03_TeamNE_TeamA2",231,1100,7386728,7387828,121.715251419794,116.732641832996,5
"653","1903_04_TeamNC_TeamA1",25,700,843069,843769,40.7387908154483,58.9608124287508,4
"654","1903_04_TeamNC_TeamA1",67,1150,2384919,2386069,96.4370014496858,91.6685114472037,5
"655","1903_04_TeamNC_TeamA1",109,1050,3908219,3909269,80.1956144840721,79.5869669174842,4
"656","1903_04_TeamNC_TeamA1",111,900,3959669,3960569,74.9925395007287,91.5091516256516,5
"657","1903_04_TeamNC_TeamA1",121,950,4380319,4381269,100.959298921728,113.699073644399,5
"658","1903_04_TeamNC_TeamA1",144,1100,5140519,5141619,96.7927732730059,105.527023634718,5
"659","1903_05_TeamND_TeamA2",57,950,1548562,1549512,89.4388226215076,95.3829012883018,4
"660","1903_05_TeamND_TeamA2",190,800,5915112,5915912,79.548469971483,98.1879492779433,4
"661","1903_05_TeamND_TeamA2",193,1000,6020562,6021562,92.4181510161878,90.278794069185,4
"662","1903_05_TeamND_TeamA2",204,900,6462462,6463362,86.7807739839692,99.0580950015032,4
"663","1903_05_TeamND_TeamA2",280,1300,9100462,9101762,119.372217707105,101.13665762901,4
"664","1903_05_TeamND_TeamA2",297,950,9645712,9646662,97.4831231318711,108.427847927793,6
"665","1903_06_TeamND_TeamA2",17,850,463274,464124,86.395616149144,102.125167042868,6
"666","1903_06_TeamND_TeamA2",29,850,821874,822724,82.2517521765245,104.857803275295,4
"667","1903_06_TeamND_TeamA2",36,1350,1060774,1062124,142.681930681578,117.965213704651,6
"668","1903_06_TeamND_TeamA2",88,850,2747574,2748424,83.7518503301363,105.655645975464,6
"669","1903_06_TeamND_TeamA2",93,1150,2889224,2890374,110.104329926716,100.464143867693,6
"670","1903_06_TeamND_TeamA2",123,800,3952974,3953774,81.4007897471572,103.430303919411,4
"671","1903_06_TeamND_TeamA2",157,900,5155474,5156374,95.6998890249914,109.186382321354,5
"672","1903_06_TeamND_TeamA2",207,900,6962224,6963124,88.3387197057718,99.1368454264716,6
"673","1903_06_TeamND_TeamA2",248,1150,8342274,8343424,106.850408055416,97.8670017507565,6
"674","1903_07_TeamND_TeamA2",74,800,2104923,2105723,78.5486005662748,100.579499652684,6
"675","1903_07_TeamND_TeamA2",81,1100,2241623,2242723,100.818001200666,95.9788689977203,5
"676","1903_07_TeamND_TeamA2",110,750,3210523,3211273,68.6483133042997,92.8541703183973,4
"677","1903_07_TeamND_TeamA2",120,650,3551923,3552573,49.3272558326286,72.6450387390144,4
"678","1903_07_TeamND_TeamA2",125,650,3680923,3681573,60.9041468427611,90.9685438361994,4
"679","1903_07_TeamND_TeamA2",290,900,9485773,9486673,98.1975359102826,115.16887302916,6
"680","1903_07_TeamND_TeamA2",313,750,10392773,10393523,69.1191651665134,93.2438859344816,4
"681","1903_07_TeamND_TeamA2",322,650,10780373,10781023,60.2240987400911,91.8505254102786,4
"682","1903_08_TeamNJ_TeamB",37,900,1172967,1173867,82.0588270394284,103.36034786854,4
"683","1903_08_TeamNJ_TeamB",54,750,1853417,1854167,67.1529704382875,91.2990229259621,4
"684","1903_08_TeamNJ_TeamB",64,1000,2157467,2158467,107.818174109743,120.068782944817,6
"685","1903_08_TeamNJ_TeamB",90,1000,3042117,3043117,108.288302456977,113.665165353996,5
"686","1903_08_TeamNJ_TeamB",101,900,3419067,3419967,83.7206043877434,96.4986184620423,4
"687","1903_08_TeamNJ_TeamB",103,1050,3571017,3572067,119.546126708762,127.95197611283,6
"688","1903_08_TeamNJ_TeamB",107,800,3651467,3652267,76.1719848279456,104.857091380569,4
"689","1903_08_TeamNJ_TeamB",111,850,3872567,3873417,96.6956418184147,119.989641105179,5
"690","1903_08_TeamNJ_TeamB",124,1200,4257267,4258467,127.501209766672,117.316609055052,5
"691","1903_08_TeamNJ_TeamB",133,1000,4622167,4623167,104.89719980549,111.436593543835,6
"692","1903_08_TeamNJ_TeamB",173,1200,6134917,6136117,110.099173817635,98.5497217624712,4
"693","1903_08_TeamNJ_TeamB",175,1100,6305267,6306367,99.9447399790892,92.4880068701428,4
"694","1903_08_TeamNJ_TeamB",190,1100,6786567,6787667,72.853871115428,67.2466564446267,6
"695","1903_08_TeamNJ_TeamB",192,1250,6849067,6850317,134.115701970121,117.487583477416,6
"696","1903_08_TeamNJ_TeamB",213,1050,7644567,7645617,100.763402690405,98.8887089761298,5
"697","1903_08_TeamNJ_TeamB",218,1100,7811617,7812717,110.540941919778,109.727888299826,6
"698","1903_08_TeamNJ_TeamB",232,1200,8367617,8368817,127.380405515705,111.899535666351,6
"699","1903_08_TeamNJ_TeamB",234,950,8418367,8419317,103.580772766139,114.496164682099,6
"700","1903_09_TeamNJ_TeamB",15,950,344834,345784,102.470147191741,108.683421161732,6
"701","1903_09_TeamNJ_TeamB",50,500,1485934,1486434,41.0554300745954,79.7645518533227,4
"702","1903_09_TeamNJ_TeamB",58,1100,1730134,1731234,121.292633672703,118.762630394835,4
"703","1903_09_TeamNJ_TeamB",60,1350,2383415,2384765,130.956891009247,104.798583235932,5
"704","1903_09_TeamNJ_TeamB",110,1050,4065915,4066965,107.293462931549,110.571622270466,5
"705","1903_09_TeamNJ_TeamB",133,900,4920115,4921015,81.380558854775,96.4547003124899,4
"706","1903_09_TeamNJ_TeamB",173,1150,6617865,6619015,92.8404652770922,86.1980543425946,4
"707","1903_09_TeamNJ_TeamB",186,750,7208115,7208865,70.1129910648975,96.2754971876438,4
"708","1903_09_TeamNJ_TeamB",193,1050,7468315,7469365,112.48818503161,115.494141115892,5
"709","1903_09_TeamNJ_TeamB",211,700,8131015,8131715,37.3813756519055,52.8329067630068,4
"710","1903_09_TeamNJ_TeamB",249,1000,9587415,9588415,113.604263464049,125.319091320537,6
"711","1903_09_TeamNJ_TeamB",263,850,10134965,10135815,71.9705262379392,91.6367258967232,4
"712","1903_10_TeamNJ_TeamB",12,600,460339,460939,43.4384199176104,76.8967639470403,4
"713","1903_10_TeamNJ_TeamB",18,650,624689,625339,58.2012501165888,87.8825886411234,4
"714","1903_10_TeamNJ_TeamB",38,800,1305639,1306439,92.5312277971823,114.330712465654,6
"715","1903_10_TeamNJ_TeamB",67,900,2270289,2271189,107.401922247263,128.238941724183,5
"716","1903_10_TeamNJ_TeamB",73,850,2552089,2552939,91.4638741222932,115.970548314876,6
"717","1903_10_TeamNJ_TeamB",95,1050,3319739,3320789,88.5073049217337,88.2427311748542,4
"718","1903_10_TeamNJ_TeamB",137,650,4690539,4691189,42.9662986685227,65.7787574241109,4
"719","1903_10_TeamNJ_TeamB",200,1300,7051422,7052722,111.866353540339,91.6607231824856,4
"720","1903_10_TeamNJ_TeamB",230,1300,8039072,8040372,134.300822497711,109.323692403349,5
"721","1903_11_TeamNC_TeamA1",52,800,1709650,1710450,80.9191848525555,102.622750170663,4
"722","1903_11_TeamNC_TeamA1",59,1150,1992100,1993250,111.099253257482,107.267860172083,6
"723","1903_11_TeamNC_TeamA1",90,550,2971150,2971700,51.2119484910814,97.4325957402361,4
"724","1903_11_TeamNC_TeamA1",98,900,8603086,8603986,88.262651451368,98.3190925210133,4
"725","1903_11_TeamNC_TeamA1",110,700,9099286,9099986,62.6284056233409,87.0441713280107,4
"726","1903_11_TeamNC_TeamA1",188,1150,11734336,11735486,113.905688265176,107.251806733709,5
"727","1903_11_TeamNC_TeamA1",193,1550,11957736,11959286,111.909318152739,78.7501244101079,4
"728","1903_11_TeamNC_TeamA1",200,850,12242436,12243286,61.7308701499343,75.4152673333312,4
"729","1903_11_TeamNC_TeamA1",231,1100,13506236,13507336,122.949798482808,120.720715182543,5
"730","1903_11_TeamNC_TeamA1",259,750,14539286,14540036,60.9731969709879,82.6508101657717,4
"731","1903_11_TeamNC_TeamA1",263,1000,14626236,14627236,117.707821517295,122.731409163474,5
"732","1903_11_TeamNC_TeamA1",264,1300,14749636,14750936,135.109526098311,110.88547065328,6
"733","1903_12_TeamNC_TeamA1",24,550,746248,746798,47.398716201677,82.5443487546854,4
"734","1903_12_TeamNC_TeamA1",35,1150,1074348,1075498,116.629737684188,111.397838090519,5
"735","1903_12_TeamNC_TeamA1",81,1000,2626804,2627804,72.127541822039,75.7809237218263,4
"736","1903_12_TeamNC_TeamA1",100,1100,3278154,3279254,112.073820036276,110.945892269496,5
"737","1903_12_TeamNC_TeamA1",115,850,3774004,3774854,77.038449042875,91.5169959765277,4
"738","1903_12_TeamNC_TeamA1",121,900,3882104,3883004,74.7879106576252,84.172896160875,4
"739","1903_12_TeamNC_TeamA1",130,750,4268804,4269554,79.8845895224685,110.087408363973,4
"740","1903_12_TeamNC_TeamA1",208,1100,7573204,7574304,109.709796469305,105.340881714029,6
"741","1903_12_TeamNC_TeamA1",218,1100,7983904,7985004,93.5061077065433,91.7024557255058,4
"742","1903_12_TeamNC_TeamA1",237,900,8706054,8706954,90.5642633473827,110.178408107414,6
"743","1903_13_TeamNG_TeamA3",49,750,1462534,1463284,60.2934935751433,75.1594671263931,4
"744","1903_13_TeamNG_TeamA3",56,950,1776684,1777634,90.10349426723,96.3341353785003,4
"745","1903_13_TeamNG_TeamA3",60,850,1866234,1867084,103.466545941329,122.282832725281,6
"746","1903_13_TeamNG_TeamA3",207,600,6887334,6887934,51.3245784739316,92.7207393459076,4
"747","1903_13_TeamNG_TeamA3",255,800,8800634,8801434,82.9508845436125,101.75493340859,4
"748","1903_14_TeamNG_TeamA3",9,1250,190582,191832,122.057562617824,103.260872573108,5
"749","1903_14_TeamNG_TeamA3",13,650,424032,424682,73.9930639684425,116.768545500322,6
"750","1903_14_TeamNG_TeamA3",45,850,1394882,1395732,78.6439611544668,91.6446734384375,4
"751","1903_14_TeamNG_TeamA3",56,1050,1713182,1714232,100.402641765067,99.947614467473,5
"752","1903_14_TeamNG_TeamA3",84,850,2780622,2781472,84.3276717689105,97.6097418968389,4
"753","1903_14_TeamNG_TeamA3",137,850,5289932,5290782,95.3919902057146,112.760179621755,6
"754","1903_14_TeamNG_TeamA3",192,750,7477471,7478221,59.6023532898949,77.7937899291706,4
"755","1903_14_TeamNG_TeamA3",233,950,9010168,9011118,98.7982697099485,103.214371083219,4
"756","1903_14_TeamNG_TeamA3",246,1150,9518218,9519368,118.980443649136,105.967039307372,6
"757","1903_15_TeamNG_TeamA3",41,800,1387119,1387919,79.3775183241271,97.7985886823134,6
"758","1903_15_TeamNG_TeamA3",47,1300,1529269,1530569,133.706891499185,111.748170234572,6
"759","1903_15_TeamNG_TeamA3",88,1000,2745069,2746069,99.6977024655106,102.189877413876,6
"760","1903_15_TeamNG_TeamA3",114,900,3724319,3725219,87.4624596464171,96.0905641286889,4
"761","1903_15_TeamNG_TeamA3",117,950,3819819,3820769,105.12789988973,115.533328828943,6
"762","1903_15_TeamNG_TeamA3",147,650,4802919,4803569,62.3720576572932,95.9483502224481,4
"763","1903_15_TeamNG_TeamA3",158,1100,5320069,5321169,110.424514397266,130.908104040469,6
"764","1903_15_TeamNG_TeamA3",243,850,8046069,8046919,69.8737604724776,81.7890081022103,4
"765","1903_15_TeamNG_TeamA3",271,550,9298719,9299269,40.1792151433116,65.8630949488874,4
"766","1903_15_TeamNG_TeamA3",293,750,10038019,10038769,50.2527754762772,68.1757229921234,4
"767","1903_16_TeamNI_TeamA3",25,800,739218,740018,75.5569773437092,94.8416977903135,6
"768","1903_16_TeamNI_TeamA3",82,1250,2516768,2518018,113.348689830023,99.594981874853,5
"769","1903_16_TeamNI_TeamA3",96,950,2971518,2972468,95.3893508745126,104.752374565893,6
"770","1903_16_TeamNI_TeamA3",141,850,4506768,4507618,96.7311188229813,115.695427051377,6
"771","1903_16_TeamNI_TeamA3",162,950,5182318,5183268,92.7423323048627,100.566298529695,5
"772","1903_16_TeamNI_TeamA3",177,800,5674968,5675768,64.6253493343672,80.1531565932272,4
"773","1903_16_TeamNI_TeamA3",219,850,6928618,6929468,68.660904627282,82.3800474967279,4
"774","1903_16_TeamNI_TeamA3",276,700,8892321,8893021,80.9247233066982,114.605201134139,6
"775","1903_17_TeamNI_TeamA3",6,1100,84869,85969,120.732476387342,114.231188907205,6
"776","1903_17_TeamNI_TeamA3",43,750,1427233,1427983,56.4402267182044,78.3041839142548,4
"777","1903_17_TeamNI_TeamA3",84,750,2837583,2838333,58.6871251224548,82.1554914151818,4
"778","1903_17_TeamNI_TeamA3",98,1100,3513363,3514463,103.391156376126,97.0242977995677,5
"779","1903_17_TeamNI_TeamA3",109,700,3966013,3966713,35.8236258809696,47.1828681019597,4
"780","1903_17_TeamNI_TeamA3",121,1000,4488513,4489513,85.9458713049279,88.8299783070384,4
"781","1903_17_TeamNI_TeamA3",138,600,4948963,4949563,52.9009477559292,85.1307075045469,4
"782","1903_17_TeamNI_TeamA3",193,1000,6972763,6973763,86.786124332085,89.8433349593404,4
"783","1903_17_TeamNI_TeamA3",203,1300,7282813,7284113,135.342672264526,114.031463857945,6
"784","1903_17_TeamNI_TeamA3",228,900,7995063,7995963,92.4291536933498,111.862158332336,6
"785","1903_17_TeamNI_TeamA3",235,950,8246363,8247313,98.3388613807021,106.321575130026,4
"786","1903_17_TeamNI_TeamA3",237,1200,8291563,8292763,129.348117307349,116.008133685407,5
"787","1903_17_TeamNI_TeamA3",255,2550,8957607,8960157,145.8982486366,88.2175569197459,5
"788","1903_18_TeamNI_TeamA3",41,900,1269731,1270631,90.0634345109679,102.184015840744,5
"789","1903_18_TeamNI_TeamA3",46,700,1371731,1372431,81.3156948243661,113.122533661101,4
"790","1903_18_TeamNI_TeamA3",50,800,1585831,1586631,69.0383115612265,84.5245192163573,4
"791","1903_18_TeamNI_TeamA3",57,900,1830381,1831281,96.8173102218093,109.567876724875,6
"792","1903_18_TeamNI_TeamA3",79,1200,2454831,2456031,113.540815005504,96.3340697769274,6
"793","1903_18_TeamNI_TeamA3",81,950,2500681,2501631,91.4554954245107,98.0083882342869,5
"794","1903_18_TeamNI_TeamA3",103,850,3280931,3281781,81.8570340760489,96.2241891370288,4
"795","1903_18_TeamNI_TeamA3",123,750,3893081,3893831,60.672176477248,71.4038959136218,4
"796","1903_18_TeamNI_TeamA3",134,950,4221381,4222331,90.8920191947352,95.5438842434777,4
"797","1903_18_TeamNI_TeamA3",154,1100,4874131,4875231,119.234675317262,117.702517560061,5
"798","1903_18_TeamNI_TeamA3",225,1050,7475531,7476581,104.466835787977,102.214267178101,6
"799","1903_18_TeamNI_TeamA3",251,1100,8435731,8436831,109.66685642214,105.414302604414,6
"800","1903_19_TeamNL_TeamB",11,1050,277001,278051,88.6780963318944,87.8045371632155,6
"801","1903_19_TeamNL_TeamB",14,800,361551,362351,70.1274369187349,88.4618104276594,6
"802","1903_19_TeamNL_TeamB",23,1650,713701,715351,145.362793755432,108.099810367933,6
"803","1903_19_TeamNL_TeamB",48,1050,1488151,1489201,97.5535782799519,92.9051000752934,4
"804","1903_19_TeamNL_TeamB",58,650,1820601,1821251,29.5351739135164,37.5798642497131,4
"805","1903_19_TeamNL_TeamB",67,1100,2126151,2127251,102.979392225633,101.611013007921,4
"806","1903_19_TeamNL_TeamB",74,1250,2374401,2375651,131.37058991917,115.494362935685,6
"807","1903_19_TeamNL_TeamB",89,750,2876951,2877701,74.9513151619369,106.82663704216,4
"808","1903_19_TeamNL_TeamB",151,950,5142701,5143651,76.9798532657724,93.0204229538374,4
"809","1903_19_TeamNL_TeamB",194,1100,6682001,6683101,117.149467195969,109.782857599442,5
"810","1903_19_TeamNL_TeamB",264,1100,8980251,8981351,109.344486171205,101.511177266335,6
"811","1903_19_TeamNL_TeamB",265,1100,9013901,9015001,109.165227683424,109.914251094209,6
"812","1903_19_TeamNL_TeamB",272,1200,9171201,9172401,108.019418464368,95.0060449081669,6
"813","1903_20_TeamNL_TeamB",9,1100,219082,220182,111.481296584786,111.434291004845,6
"814","1903_20_TeamNL_TeamB",16,1250,512882,514132,119.905824890622,104.551991562327,5
"815","1903_20_TeamNL_TeamB",31,600,1206416,1207016,53.7853254992826,88.8623455610303,4
"816","1903_20_TeamNL_TeamB",65,650,2351966,2352616,64.5272843464886,94.1773758797902,4
"817","1903_20_TeamNL_TeamB",102,850,3381616,3382466,75.4625273451902,99.2601784745534,4
"818","1903_20_TeamNL_TeamB",124,1550,4095316,4096866,125.757476587788,93.0968309021499,5
"819","1903_20_TeamNL_TeamB",131,750,4218866,4219616,57.7552966257957,86.4978470086489,4
"820","1903_20_TeamNL_TeamB",188,750,6368066,6368816,75.6566507088276,105.981214514101,4
"821","1903_20_TeamNL_TeamB",196,550,6680066,6680616,45.2797150491906,78.1145527468305,4
"822","1903_20_TeamNL_TeamB",220,750,7624816,7625566,72.3657451153494,97.6324300790159,4
"823","1903_20_TeamNL_TeamB",224,850,7705266,7706116,78.1348068941675,94.8470541242795,4
"824","1903_20_TeamNL_TeamB",245,1100,8500666,8501766,122.344395685756,120.801868569938,6
"825","1903_21_TeamNL_TeamB",36,1150,1111608,1112758,123.514564228201,116.649957205061,5
"826","1903_21_TeamNL_TeamB",39,1450,1176358,1177808,135.914807220409,98.9074710235197,6
"827","1903_21_TeamNL_TeamB",62,1100,1919758,1920858,130.427717698078,124.458517667195,5
"828","1903_21_TeamNL_TeamB",74,1350,2386508,2387858,125.497061309065,103.330363042814,6
"829","1903_21_TeamNL_TeamB",101,1200,3350108,3351308,116.524679371467,101.428430304753,6
"830","1903_21_TeamNL_TeamB",105,1200,3458108,3459308,117.587079953711,107.730466530781,6
"831","1903_21_TeamNL_TeamB",132,1100,4526908,4528008,110.29245370687,109.122078879342,6
"832","1903_21_TeamNL_TeamB",139,1100,4829508,4830608,122.532468674256,120.665473560813,5
"833","1903_21_TeamNL_TeamB",167,1050,5816958,5818008,90.3682083843883,99.8050067293153,4
"834","1903_21_TeamNL_TeamB",172,900,5953608,5954508,89.6551189990466,107.076474966981,4
"835","1903_22_TeamNA_TeamA1",4,750,70513,71263,70.3843158651202,98.7766648204394,4
"836","1903_22_TeamNA_TeamA1",20,700,556763,557463,66.744613785266,98.9642428408861,4
"837","1903_22_TeamNA_TeamA1",52,1200,1447863,1449063,129.299945004684,115.136600982491,6
"838","1903_22_TeamNA_TeamA1",76,850,2150063,2150913,83.5211972827036,101.969395093828,4
"839","1903_22_TeamNA_TeamA1",135,550,3826913,3827463,54.3755785889244,98.3574219078546,4
"840","1903_22_TeamNA_TeamA1",152,1100,4394463,4395563,105.050003240899,100.659322988778,6
"841","1903_22_TeamNA_TeamA1",225,700,6870313,6871013,55.4845545285457,90.6252744362768,4
"842","1903_22_TeamNA_TeamA1",246,1350,7653313,7654663,110.162525407039,85.2069140643964,4
"843","1903_23_TeamNA_TeamA1",26,500,674610,675110,48.5851421005855,98.3194633605332,4
"844","1903_23_TeamNA_TeamA1",29,800,730210,731010,77.5890218911612,93.5795691942148,6
"845","1903_23_TeamNA_TeamA1",46,900,1233560,1234460,90.1067843593911,103.176938589992,5
"846","1903_23_TeamNA_TeamA1",67,600,2021044,2021644,47.7247619884012,77.9814246621482,4
"847","1903_23_TeamNA_TeamA1",110,750,3546194,3546944,41.1861474911731,52.6813812181059,4
"848","1903_23_TeamNA_TeamA1",115,750,3674094,3674844,68.2768795584605,90.4910587721829,4
"849","1903_23_TeamNA_TeamA1",140,2200,4399694,4401894,134.562922066376,78.8971809444163,4
"850","1903_23_TeamNA_TeamA1",254,650,8030344,8030994,59.9193810605439,88.8329480094109,4
"851","1903_23_TeamNA_TeamA1",273,950,8583694,8584644,91.3034766014564,99.0879904181559,6
"852","1903_24_TeamNA_TeamA1",57,600,1763719,1764319,52.7217232642167,93.3505343300469,4
"853","1903_24_TeamNA_TeamA1",60,900,1817469,1818369,82.7656108699189,91.2462557076633,4
"854","1903_24_TeamNA_TeamA1",108,800,3340469,3341269,62.0476375386682,79.3865242662917,4
"855","1903_24_TeamNA_TeamA1",123,950,3894269,3895219,102.993629821767,112.947331473178,6
"856","1903_24_TeamNA_TeamA1",142,700,4484019,4484719,68.7523500464,94.7883821296448,4
"857","1903_24_TeamNA_TeamA1",147,800,4579919,4580719,72.7940698272382,92.0350611717361,4
"858","1903_24_TeamNA_TeamA1",156,1100,4904969,4906069,105.841783799218,98.9178040514101,5
"859","1903_24_TeamNA_TeamA1",168,1050,5416119,5417169,103.858179655974,101.240494285012,5
"860","1903_24_TeamNA_TeamA1",207,1200,6743769,6744969,96.4236291475055,82.5599227900246,5
"861","1903_25_TeamNH_TeamA3",39,950,1189711,1190661,88.1802798723525,94.5584506390856,4
"862","1903_25_TeamNH_TeamA3",67,750,2134811,2135561,72.757040869754,94.7035201994379,4
"863","1903_25_TeamNH_TeamA3",76,700,2492311,2493011,61.5259251399749,93.4153980627039,4
"864","1903_25_TeamNH_TeamA3",111,1400,3650161,3651561,143.070540400573,107.824222782476,5
"865","1903_25_TeamNH_TeamA3",113,1450,3798311,3799761,142.738031469636,107.341421262343,6
"866","1903_25_TeamNH_TeamA3",151,1100,5231761,5232861,122.599227760369,118.950411194689,6
"867","1903_25_TeamNH_TeamA3",166,750,5694361,5695111,70.0172094761466,100.463874334185,4
"868","1903_25_TeamNH_TeamA3",224,650,8023911,8024561,64.0614712368287,92.9696848088409,4
"869","1903_25_TeamNH_TeamA3",241,850,8613911,8614761,80.9001849316797,100.118890317025,6
"870","1903_25_TeamNH_TeamA3",259,1000,9346661,9347661,87.0436283018356,88.4178575230203,6
"871","1903_25_TeamNK_TeamB",3,850,83165,84015,80.1870879489228,99.8491653465361,4
"872","1903_25_TeamNK_TeamB",50,1000,1812565,1813565,101.867772791763,105.437477977847,5
"873","1903_25_TeamNK_TeamB",77,900,2806065,2806965,105.782498937595,121.46710388307,5
"874","1903_25_TeamNK_TeamB",118,900,4311915,4312815,85.082533388695,99.2644369771387,4
"875","1903_25_TeamNK_TeamB",120,1100,4480115,4481215,111.713008670328,100.045597920241,6
"876","1903_25_TeamNK_TeamB",149,1700,5465365,5467065,146.953514506275,93.1694062947231,6
"877","1903_25_TeamNK_TeamB",156,1100,5811965,5813065,104.571195003081,93.6898966085835,6
"878","1903_25_TeamNK_TeamB",179,1300,6924265,6925565,109.057574586185,85.7236484129255,4
"879","1903_25_TeamNK_TeamB",184,700,7190965,7191665,89.2500909432544,125.974262579557,5
"880","1903_25_TeamNK_TeamB",188,1100,7275465,7276565,127.719443567709,124.117544747646,5
"881","1903_25_TeamNK_TeamB",219,850,8600815,8601665,85.1132092451291,107.770913275152,4
"882","1903_25_TeamNK_TeamB",237,1200,9071615,9072815,128.202188945003,110.560933405228,5
"883","1903_25_TeamNK_TeamB",258,850,9961215,9962065,68.655980544048,83.562528900676,4
"884","1903_26_TeamNH_TeamA3",7,900,168363,169263,79.1067868269517,85.1598405444731,4
"885","1903_26_TeamNH_TeamA3",58,650,1833713,1834363,51.3230043684793,70.8127963303974,4
"886","1903_26_TeamNH_TeamA3",83,800,2671563,2672363,60.5087991714253,71.6479071709055,4
"887","1903_26_TeamNH_TeamA3",197,800,6468513,6469313,60.4025048239694,76.3142746628281,4
"888","1903_26_TeamNH_TeamA3",255,1150,8692663,8693813,123.192956239758,111.599299176796,5
"889","1903_26_TeamNH_TeamA3",278,1350,9654863,9656213,143.885856807278,114.870058467367,6
"890","1903_26_TeamNH_TeamA3",284,900,9819813,9820713,67.2822402076126,75.2924135441089,4
"891","1903_26_TeamNH_TeamA3",340,900,11998313,11999213,89.627626899376,104.753936336356,5
"892","1903_26_TeamNK_TeamB",10,1150,361060,362210,119.487565685599,110.203875546476,5
"893","1903_26_TeamNK_TeamB",26,800,850429,851229,65.6814649250334,81.83324317535,4
"894","1903_26_TeamNK_TeamB",42,650,1302129,1302779,63.6539498080012,88.3089771969859,4
"895","1903_26_TeamNK_TeamB",59,1050,1824379,1825429,115.4126408282,114.515489556656,6
"896","1903_26_TeamNK_TeamB",74,950,2277779,2278729,107.69460108266,118.549282776537,5
"897","1903_26_TeamNK_TeamB",76,1550,2331629,2333179,134.127332243452,93.5196228856842,6
"898","1903_26_TeamNK_TeamB",118,850,3773229,3774079,91.9455096125297,109.951550711045,6
"899","1903_26_TeamNK_TeamB",174,1100,5760629,5761729,119.744275330033,113.4054544207,5
"900","1903_26_TeamNK_TeamB",183,1400,5990829,5992229,138.221836096475,111.618875641749,6
"901","1903_26_TeamNK_TeamB",193,1150,6403579,6404729,101.757257460515,98.8078849592544,5
"902","1903_26_TeamNK_TeamB",199,1000,6763479,6764479,90.0139047609571,94.1468611854656,4
"903","1903_26_TeamNK_TeamB",237,850,8091379,8092229,92.4199582091325,115.11524855899,6
"904","1903_26_TeamNK_TeamB",239,1050,8151629,8152679,107.945835927289,103.207282009344,6
"905","1903_27_TeamNH_TeamA3",24,900,701957,702857,89.5828512462074,104.428772407995,4
"906","1903_27_TeamNH_TeamA3",50,1400,1615507,1616907,150.505636435531,112.385410277656,6
"907","1903_27_TeamNH_TeamA3",92,950,2909174,2910124,95.4362891380438,106.398479326648,5
"908","1903_27_TeamNH_TeamA3",99,900,3039724,3040624,100.119862799357,117.529119324559,6
"909","1903_27_TeamNH_TeamA3",126,1100,3959224,3960324,118.969994896073,112.881760834432,6
"910","1903_27_TeamNH_TeamA3",128,950,4117874,4118824,83.0054994820738,84.4510184358477,4
"911","1903_27_TeamNH_TeamA3",136,850,6840774,6841624,65.7538566049411,71.7466775598989,4
"912","1903_27_TeamNH_TeamA3",143,1050,7181974,7183024,98.180040718808,95.2845012028354,5
"913","1903_27_TeamNH_TeamA3",150,950,7341824,7342774,108.669662881265,122.022217832101,6
"914","1903_27_TeamNH_TeamA3",236,700,10496074,10496774,46.9119046744203,68.8210401920625,4
"915","1903_27_TeamNK_TeamB",3,1188,93893,95081,122.882680360118,111.800926641868,6
"916","1903_27_TeamNK_TeamB",102,891,3981924,3982815,76.1024178477224,88.4076297057245,4
"917","1903_27_TeamNK_TeamB",123,1353,4657838,4659191,124.094853354018,94.0951014768085,6
"918","1903_27_TeamNK_TeamB",135,891,5030606,5031497,84.6295418435576,97.9694942565269,4
"919","1903_27_TeamNK_TeamB",139,1221,5217353,5218574,91.2682706331131,79.4771285011617,4
"920","1903_27_TeamNK_TeamB",247,1056,9063083,9064139,115.412831318032,112.382037291751,6
"921","1903_27_TeamNK_TeamB",273,990,10026783,10027773,85.5442305460704,88.9836884219757,4
"922","1903_28_TeamNF_TeamA2",110,700,3547001,3547701,83.87093628086,120.646756355657,6
"923","1903_28_TeamNF_TeamA2",168,850,5714101,5714951,91.1238432568327,109.467234943611,5
"924","1903_28_TeamNF_TeamA2",196,1050,6899751,6900801,110.706250135871,112.80740201479,6
"925","1903_28_TeamNF_TeamA2",256,850,8914701,8915551,84.1906697292264,100.666113093238,4
"926","1903_29_TeamNF_TeamA2",24,800,617204,618004,81.3872411557114,103.475442272765,5
"927","1903_29_TeamNF_TeamA2",31,650,935204,935854,63.6939472031352,96.3987072944233,4
"928","1903_29_TeamNF_TeamA2",60,950,1832854,1833804,94.0292335394114,101.596883675322,5
"929","1903_29_TeamNF_TeamA2",67,1200,2187529,2188729,132.049242120825,115.929219079681,5
"930","1903_29_TeamNF_TeamA2",76,600,2494079,2494679,70.5245973304742,114.572987848385,6
"931","1903_29_TeamNF_TeamA2",102,1200,3396279,3397479,119.144326702775,107.824458788661,4
"932","1903_29_TeamNF_TeamA2",114,1000,3806221,3807221,103.90647243502,105.058902433833,6
"933","1903_29_TeamNF_TeamA2",130,900,4383821,4384721,74.274971589566,84.2809842589287,4
"934","1903_29_TeamNF_TeamA2",143,950,4804771,4805721,102.770380151636,113.696208094715,5
"935","1903_29_TeamNF_TeamA2",197,1150,6620821,6621971,96.1864946673412,85.2630747232361,4
"936","1903_29_TeamNF_TeamA2",211,750,7031371,7032121,59.142954817599,79.2113307534551,4
"937","1903_29_TeamNF_TeamA2",232,1050,7825921,7826971,120.825672887094,121.696442705392,5
"938","1903_29_TeamNF_TeamA2",235,800,8016521,8017321,79.2132346240985,103.038298940964,5
"939","1903_29_TeamNF_TeamA2",254,900,8746971,8747871,85.3072346734988,92.9067997805398,4
"940","1903_29_TeamNF_TeamA2",255,900,8892671,8893571,85.1858826748696,94.9249349001034,4
"941","1903_30_TeamNB_TeamA1",3,1150,87884,89034,110.150947426954,98.8305461876835,5
"942","1903_30_TeamNB_TeamA1",22,750,609984,610734,77.8070522924951,104.173632064718,4
"943","1903_30_TeamNB_TeamA1",29,750,833534,834284,68.3820128999291,93.4509007055418,4
"944","1903_30_TeamNB_TeamA1",61,1100,1856634,1857734,90.4337414170071,88.7592154248009,4
"945","1903_30_TeamNB_TeamA1",64,1150,1914134,1915284,118.445008151702,109.866634612733,6
"946","1903_30_TeamNB_TeamA1",104,1150,3320371,3321521,117.464967658848,106.754403437678,5
"947","1903_30_TeamNB_TeamA1",116,550,3674021,3674571,50.7296619985394,87.8288796377846,4
"948","1903_30_TeamNB_TeamA1",138,1150,4537471,4538621,113.218912824007,102.876847969478,5
"949","1903_30_TeamNB_TeamA1",171,1250,5662871,5664121,120.552962273503,104.468186273202,6
"950","1903_30_TeamNB_TeamA1",211,1300,7333248,7334548,128.713127833537,106.972854548364,5
"951","1903_30_TeamNB_TeamA1",219,800,7477648,7478448,85.1302509328013,105.065453810684,4
"952","1903_30_TeamNB_TeamA1",226,550,7777298,7777848,64.1925686652143,111.065127489821,4
"953","1903_30_TeamNB_TeamA1",252,750,8628948,8629698,73.0779133907278,94.9238985066964,4
"954","1903_30_TeamNB_TeamA1",263,1000,9003748,9004748,99.1290682648691,105.569493479044,5
"955","1903_30_TeamNB_TeamA1",268,750,9113948,9114698,62.6704533443904,81.9923113178246,4
"956","1903_30_TeamNF_TeamA2",1,1400,17297,18697,135.708457015144,103.118092704124,6
"957","1903_30_TeamNF_TeamA2",30,800,768047,768847,85.960124225341,106.348141657335,5
"958","1903_30_TeamNF_TeamA2",32,1000,833647,834647,111.980784657507,119.255259726457,6
"959","1903_30_TeamNF_TeamA2",87,1500,2425597,2427097,137.665063117886,100.507279299494,5
"960","1903_30_TeamNF_TeamA2",106,1350,3164797,3166147,128.789969924462,107.412469507006,6
"961","1903_30_TeamNF_TeamA2",113,1350,3320847,3322197,142.293842976974,111.290852028138,5
"962","1903_30_TeamNF_TeamA2",131,950,3954047,3954997,103.356721666703,114.16317177636,6
"963","1903_30_TeamNF_TeamA2",138,1900,4204497,4206397,130.948649350216,81.9746858570001,4
"964","1903_30_TeamNF_TeamA2",140,1500,4262997,4264497,130.065339364934,93.2130443461902,6
"965","1903_30_TeamNF_TeamA2",147,1050,4514047,4515097,119.290464868884,119.030300307144,5
"966","1903_30_TeamNF_TeamA2",171,800,5373547,5374347,71.3050094550204,88.9575445799578,4
"967","1903_30_TeamNF_TeamA2",193,1550,6013247,6014797,131.707385217892,106.743870208802,5
"968","1903_30_TeamNF_TeamA2",205,850,6459397,6460247,86.0647231801621,104.784920143505,6
"969","1903_30_TeamNF_TeamA2",207,850,6626997,6627847,83.9956052477827,100.327617360767,6
"970","1903_30_TeamNF_TeamA2",212,1000,6761047,6762047,105.91848183539,110.837114784122,6
"971","1903_30_TeamNF_TeamA2",259,1150,8531397,8532547,117.967531140594,112.233527742152,5
"972","1903_31_TeamNB_TeamA1",18,1250,505992,507242,126.843225619085,106.775991831545,5
"973","1903_31_TeamNB_TeamA1",53,1050,1877338,1878388,83.9743072846408,83.9296513089188,6
"974","1903_31_TeamNB_TeamA1",124,1250,4349388,4350638,123.253501225211,104.622857986142,6
"975","1903_31_TeamNB_TeamA1",132,1000,4675388,4676388,117.981773386572,125.940226534871,6
"976","1903_31_TeamNB_TeamA1",150,800,5205838,5206638,74.3357766636664,94.6865063582345,4
"977","1903_31_TeamNB_TeamA1",221,1100,7617438,7618538,121.14169285003,115.716544297422,5
"978","1903_31_TeamNB_TeamA1",241,1050,8394238,8395288,99.0712978430351,99.0163612158794,4
"979","1903_31_TeamNB_TeamA1",284,850,9925038,9925888,78.7346799694103,91.9570619992689,4
"980","1903_31_TeamNB_TeamA1",290,750,10200188,10200938,67.6980125704337,95.1878157168866,4
"981","1903_31_TeamNB_TeamA1",297,700,10357638,10358338,70.4489899595553,102.027386959524,4
"982","1903_32_TeamNB_TeamA1",3,850,48588,49438,82.3424341635762,99.8996526088655,4
"983","1903_32_TeamNB_TeamA1",18,1100,499788,500888,118.492592552864,114.839356607223,5
"984","1903_32_TeamNB_TeamA1",39,1300,1105988,1107288,142.078890083338,117.538421719993,5
"985","1903_32_TeamNB_TeamA1",42,1150,1168988,1170138,103.175249766249,94.5542575756718,6
"986","1903_32_TeamNB_TeamA1",54,1250,1673888,1675138,105.290867619963,88.9336750270806,4
"987","1903_32_TeamNB_TeamA1",58,1250,1745688,1746938,113.073978798449,96.6794018498504,6
"988","1903_32_TeamNB_TeamA1",74,750,2152888,2153638,79.0756847470238,103.004506122163,5
"989","1903_32_TeamNB_TeamA1",76,950,2311288,2312238,103.272720487352,115.819852604072,5
"990","1903_32_TeamNB_TeamA1",80,1200,2575177,2576377,94.2522566427986,81.2374214076088,6
"991","1903_32_TeamNB_TeamA1",84,700,2653577,2654277,65.7598179160282,97.2951052998107,4
"992","1903_32_TeamNB_TeamA1",132,1150,4350527,4351677,117.037384916165,114.736797940969,5
"993","1903_32_TeamNB_TeamA1",144,1150,4758777,4759927,109.320320932318,100.6228803318,6
