"","game_str","play_id","pos_throw","ball_in","ball_out","time_transfer"
"1","1900_01_TeamKJ_TeamB",42,6,1363362,1364419,1057
"2","1900_01_TeamKJ_TeamB",50,6,1713052,1714042,990
"3","1900_01_TeamKJ_TeamB",55,4,1824378,1825467,1089
"4","1900_01_TeamKJ_TeamB",57,4,1876724,1878308,1584
"5","1900_01_TeamKJ_TeamB",66,5,2320808,2321633,825
"6","1900_01_TeamKJ_TeamB",80,6,2822221,2823080,859
"7","1900_01_TeamKJ_TeamB",86,5,2940809,2942360,1551
"8","1900_01_TeamKJ_TeamB",97,5,3265183,3266536,1353
"9","1900_01_TeamKJ_TeamB",124,4,4133317,4134241,924
"10","1900_01_TeamKJ_TeamB",183,5,6091906,6093490,1584
"11","1900_01_TeamKJ_TeamB",239,6,7890487,7891642,1155
"12","1900_01_TeamKJ_TeamB",242,6,8173077,8174133,1056
"13","1900_01_TeamKJ_TeamB",251,5,8414740,8416027,1287
"14","1900_01_TeamKJ_TeamB",253,5,8576894,8577983,1089
"15","1900_02_TeamKJ_TeamB",71,5,2311822,2312350,528
"16","1900_02_TeamKJ_TeamB",276,4,10540194,10541943,1749
"17","1900_03_TeamKJ_TeamB",40,5,1404876,1406295,1419
"18","1900_03_TeamKJ_TeamB",111,6,4617131,4618418,1287
"19","1900_03_TeamKJ_TeamB",138,5,5664845,5666331,1486
"20","1900_03_TeamKJ_TeamB",142,5,5950439,5951396,957
"21","1900_03_TeamKJ_TeamB",145,5,6065626,6067574,1948
"22","1900_03_TeamKJ_TeamB",147,4,6259894,6261017,1123
"23","1900_03_TeamKJ_TeamB",165,6,6823424,6824150,726
"24","1900_04_TeamKK_TeamB",15,4,430661,431783,1122
"25","1900_04_TeamKK_TeamB",68,6,2169502,2171120,1618
"26","1900_04_TeamKK_TeamB",70,5,2242180,2243401,1221
"27","1900_04_TeamKK_TeamB",128,6,4459331,4459992,661
"28","1900_04_TeamKK_TeamB",195,6,6770416,6771109,693
"29","1900_04_TeamKK_TeamB",206,5,7119082,7120600,1518
"30","1900_04_TeamKK_TeamB",220,6,7654425,7655019,594
"31","1900_04_TeamKK_TeamB",221,4,7688387,7689641,1254
"32","1900_05_TeamKK_TeamB",61,4,2466233,2467091,858
"33","1900_05_TeamKK_TeamB",117,4,4391058,4392082,1024
"34","1900_05_TeamKK_TeamB",160,4,6055374,6055968,594
"35","1900_05_TeamKK_TeamB",210,5,8064263,8064758,495
"36","1900_06_TeamKL_TeamB",6,6,107611,109063,1452
"37","1900_06_TeamKL_TeamB",59,4,1512572,1513398,826
"38","1900_06_TeamKL_TeamB",60,6,1662647,1663802,1155
"39","1900_06_TeamKL_TeamB",79,4,2419025,2420543,1518
"40","1900_06_TeamKL_TeamB",111,6,3500471,3501197,726
"41","1900_06_TeamKL_TeamB",135,4,4593699,4594260,561
"42","1900_06_TeamKL_TeamB",144,4,4850643,4852458,1815
"43","1900_06_TeamKL_TeamB",146,6,5011015,5012434,1419
"44","1900_06_TeamKL_TeamB",150,6,5097059,5098148,1089
"45","1900_06_TeamKL_TeamB",152,6,5143926,5145115,1189
"46","1900_06_TeamKL_TeamB",158,6,5408000,5409419,1419
"47","1900_06_TeamKL_TeamB",164,4,5578109,5578604,495
"48","1900_07_TeamKL_TeamB",8,6,155650,156937,1287
"49","1900_07_TeamKL_TeamB",11,6,208953,209976,1023
"50","1900_07_TeamKL_TeamB",15,6,403584,404673,1089
"51","1900_07_TeamKL_TeamB",21,4,515141,516527,1386
"52","1900_07_TeamKL_TeamB",83,6,2366992,2367850,858
"53","1900_07_TeamKL_TeamB",99,6,2980227,2981283,1056
"54","1900_07_TeamKL_TeamB",101,4,3026698,3028184,1486
"55","1900_07_TeamKL_TeamB",131,4,4142370,4143294,924
"56","1900_07_TeamKL_TeamB",134,5,4316406,4317330,924
"57","1900_07_TeamKL_TeamB",156,5,5192592,5193912,1320
"58","1900_07_TeamKL_TeamB",164,6,5454916,5456401,1485
"59","1900_07_TeamKL_TeamB",185,6,6462034,6462892,858
"60","1900_07_TeamKL_TeamB",187,4,6509231,6510287,1056
"61","1900_08_TeamKL_TeamB",4,4,95364,96057,693
"62","1900_08_TeamKL_TeamB",14,4,427033,428155,1122
"63","1900_08_TeamKL_TeamB",52,5,1753970,1755026,1056
"64","1900_08_TeamKL_TeamB",58,4,2117257,2118644,1387
"65","1900_08_TeamKL_TeamB",82,6,3107708,3108995,1287
"66","1900_08_TeamKL_TeamB",115,5,4209749,4210673,924
"67","1900_08_TeamKL_TeamB",130,5,4722912,4723968,1056
"68","1900_08_TeamKL_TeamB",134,5,4821696,4823248,1552
"69","1900_08_TeamKL_TeamB",174,6,6481226,6482051,825
"70","1900_08_TeamKL_TeamB",179,5,6583608,6585126,1518
"71","1900_08_TeamKL_TeamB",186,5,6935640,6936168,528
"72","1900_08_TeamKL_TeamB",207,6,7788492,7789713,1221
"73","1900_08_TeamKL_TeamB",220,6,8256571,8257990,1419
"74","1900_08_TeamKL_TeamB",228,5,8633060,8635304,2244
"75","1900_08_TeamKL_TeamB",242,4,9162660,9164145,1485
"76","1900_08_TeamKL_TeamB",257,6,9783849,9784938,1089
"77","1900_09_TeamKK_TeamB",11,6,371437,372955,1518
"78","1900_09_TeamKK_TeamB",35,6,1156925,1158378,1453
"79","1900_09_TeamKK_TeamB",58,4,1860727,1862575,1848
"80","1900_09_TeamKK_TeamB",91,5,3299056,3299848,792
"81","1900_09_TeamKK_TeamB",155,6,5825102,5826191,1089
"82","1900_09_TeamKK_TeamB",160,4,5970522,5971776,1254
"83","1900_09_TeamKK_TeamB",170,4,6324832,6325558,726
"84","1900_09_TeamKK_TeamB",197,6,7497635,7498890,1255
"85","1900_09_TeamKK_TeamB",228,6,8950025,8951378,1353
"86","1900_09_TeamKK_TeamB",242,4,9509231,9510518,1287
"87","1901_01_TeamLG_TeamA3",21,6,681576,682726,1150
"88","1901_01_TeamLG_TeamA3",26,6,906226,907276,1050
"89","1901_01_TeamLG_TeamA3",28,4,957476,958176,700
"90","1901_01_TeamLG_TeamA3",43,6,1560925,1562175,1250
"91","1901_01_TeamLG_TeamA3",72,6,2383675,2385175,1500
"92","1901_01_TeamLG_TeamA3",103,5,3386574,3388174,1600
"93","1901_01_TeamLG_TeamA3",119,5,3833673,3834523,850
"94","1901_01_TeamLG_TeamA3",176,6,5883571,5884371,800
"95","1901_01_TeamLG_TeamA3",223,6,7346520,7347220,700
"96","1901_01_TeamLG_TeamA3",235,5,7810681,7811931,1250
"97","1901_01_TeamLG_TeamA3",241,4,7985631,7986731,1100
"98","1901_02_TeamLG_TeamA3",33,4,977111,978261,1150
"99","1901_02_TeamLG_TeamA3",69,4,2218260,2218860,600
"100","1901_02_TeamLG_TeamA3",125,5,5202695,5204295,1600
"101","1901_02_TeamLG_TeamA3",229,6,8863692,8864442,750
"102","1901_02_TeamLG_TeamA3",236,6,9198392,9199392,1000
"103","1901_02_TeamLG_TeamA3",296,6,11315440,11316490,1050
"104","1901_03_TeamLG_TeamA3",21,5,677679,678429,750
"105","1901_03_TeamLG_TeamA3",88,6,2933065,2934115,1050
"106","1901_03_TeamLG_TeamA3",90,5,2979015,2980665,1650
"107","1901_03_TeamLG_TeamA3",96,6,3105815,3107115,1300
"108","1901_03_TeamLG_TeamA3",122,5,4356064,4357414,1350
"109","1901_03_TeamLG_TeamA3",144,5,5092713,5094313,1600
"110","1901_03_TeamLG_TeamA3",147,4,5281163,5282613,1450
"111","1901_03_TeamLG_TeamA3",162,6,5697412,5698112,700
"112","1901_03_TeamLG_TeamA3",168,6,5963712,5964862,1150
"113","1901_03_TeamLG_TeamA3",171,4,6023562,6024412,850
"114","1901_03_TeamLG_TeamA3",176,5,6171812,6172912,1100
"115","1901_03_TeamLG_TeamA3",182,6,6523112,6524012,900
"116","1901_03_TeamLG_TeamA3",205,5,7680554,7682604,2050
"117","1901_03_TeamLG_TeamA3",235,5,8926703,8928603,1900
"118","1901_03_TeamLG_TeamA3",256,6,9749002,9749852,850
"119","1901_04_TeamLI_TeamA3",71,6,2188867,2189867,1000
"120","1901_04_TeamLI_TeamA3",91,6,2776616,2778066,1450
"121","1901_04_TeamLI_TeamA3",142,6,4485015,4485915,900
"122","1901_04_TeamLI_TeamA3",186,6,6053913,6054413,500
"123","1901_04_TeamLI_TeamA3",196,4,6458413,6459213,800
"124","1901_04_TeamLI_TeamA3",237,4,7896611,7898061,1450
"125","1901_04_TeamLI_TeamA3",248,4,8293711,8294561,850
"126","1901_04_TeamLI_TeamA3",259,4,8779760,8780710,950
"127","1901_04_TeamLI_TeamA3",295,4,10020759,10021509,750
"128","1901_05_TeamLI_TeamA3",119,5,4004852,4005702,850
"129","1901_05_TeamLI_TeamA3",162,5,5588000,5588750,750
"130","1901_05_TeamLI_TeamA3",243,4,8267448,8268048,600
"131","1901_05_TeamLI_TeamA3",247,4,8482447,8483647,1200
"132","1901_05_TeamLI_TeamA3",250,6,8561447,8562397,950
"133","1901_05_TeamLI_TeamA3",295,5,9942796,9943896,1100
"134","1901_05_TeamLI_TeamA3",299,4,10090146,10091546,1400
"135","1901_05_TeamLI_TeamA3",310,6,10536695,10537845,1150
"136","1901_05_TeamLI_TeamA3",334,6,11424395,11425595,1200
"137","1901_06_TeamLI_TeamA3",18,5,568684,570684,2000
"138","1901_06_TeamLI_TeamA3",30,4,1005583,1006583,1000
"139","1901_06_TeamLI_TeamA3",46,6,1448283,1448983,700
"140","1901_06_TeamLI_TeamA3",64,6,1972882,1973782,900
"141","1901_06_TeamLI_TeamA3",71,4,2252382,2252982,600
"142","1901_06_TeamLI_TeamA3",84,4,2720582,2721932,1350
"143","1901_06_TeamLI_TeamA3",87,6,2893281,2893781,500
"144","1901_06_TeamLI_TeamA3",131,5,4591180,4592980,1800
"145","1901_06_TeamLI_TeamA3",154,6,5392529,5393579,1050
"146","1901_06_TeamLI_TeamA3",161,6,5681779,5682729,950
"147","1901_06_TeamLI_TeamA3",196,5,7067027,7068627,1600
"148","1901_06_TeamLI_TeamA3",215,4,7730677,7731927,1250
"149","1901_06_TeamLI_TeamA3",216,4,7830777,7832027,1250
"150","1901_06_TeamLI_TeamA3",238,6,8745526,8747176,1650
"151","1901_07_TeamLK_TeamB",6,6,118254,119454,1200
"152","1901_07_TeamLK_TeamB",24,4,815953,817403,1450
"153","1901_07_TeamLK_TeamB",38,6,1207903,1209103,1200
"154","1901_07_TeamLK_TeamB",53,5,1678453,1679453,1000
"155","1901_07_TeamLK_TeamB",54,4,1717003,1717703,700
"156","1901_07_TeamLK_TeamB",66,5,2238852,2240402,1550
"157","1901_07_TeamLK_TeamB",125,5,4367450,4368200,750
"158","1901_07_TeamLK_TeamB",164,5,5984998,5985598,600
"159","1901_07_TeamLK_TeamB",182,5,6642798,6644498,1700
"160","1901_07_TeamLK_TeamB",194,6,7166647,7167597,950
"161","1901_07_TeamLK_TeamB",214,5,7876847,7877447,600
"162","1901_07_TeamLK_TeamB",230,5,8599646,8600846,1200
"163","1901_07_TeamLK_TeamB",249,4,9380895,9382095,1200
"164","1901_08_TeamLK_TeamB",40,4,1249292,1249842,550
"165","1901_08_TeamLK_TeamB",62,6,1878892,1880192,1300
"166","1901_08_TeamLK_TeamB",84,4,2802141,2802941,800
"167","1901_08_TeamLK_TeamB",111,6,3585090,3585790,700
"168","1901_08_TeamLK_TeamB",117,6,3867690,3869340,1650
"169","1901_08_TeamLK_TeamB",139,6,4690739,4691639,900
"170","1901_08_TeamLK_TeamB",143,4,4910039,4911439,1400
"171","1901_08_TeamLK_TeamB",158,6,5456438,5456888,450
"172","1901_08_TeamLK_TeamB",184,5,6573037,6574237,1200
"173","1901_08_TeamLK_TeamB",193,5,6959787,6960887,1100
"174","1901_08_TeamLK_TeamB",248,6,9217785,9219035,1250
"175","1901_09_TeamLK_TeamB",11,6,526232,527682,1450
"176","1901_09_TeamLK_TeamB",12,6,566032,567532,1500
"177","1901_09_TeamLK_TeamB",19,6,826082,827382,1300
"178","1901_09_TeamLK_TeamB",38,6,1316781,1317331,550
"179","1901_09_TeamLK_TeamB",42,6,1525481,1526181,700
"180","1901_09_TeamLK_TeamB",53,6,2161133,2162283,1150
"181","1901_09_TeamLK_TeamB",78,6,2875383,2876383,1000
"182","1901_09_TeamLK_TeamB",96,6,3685382,3686632,1250
"183","1901_09_TeamLK_TeamB",160,4,6061930,6062580,650
"184","1901_09_TeamLK_TeamB",193,4,7363928,7364628,700
"185","1901_09_TeamLK_TeamB",205,5,7775578,7777328,1750
"186","1901_09_TeamLK_TeamB",207,6,7825328,7826078,750
"187","1901_10_TeamLJ_TeamB",10,6,430716,431166,450
"188","1901_10_TeamLJ_TeamB",29,6,1094865,1095915,1050
"189","1901_10_TeamLJ_TeamB",37,4,1373565,1374465,900
"190","1901_10_TeamLJ_TeamB",84,4,3058214,3059464,1250
"191","1901_10_TeamLJ_TeamB",87,6,3256113,3257413,1300
"192","1901_10_TeamLJ_TeamB",93,6,3375313,3376263,950
"193","1901_10_TeamLJ_TeamB",132,4,5068512,5069362,850
"194","1901_10_TeamLJ_TeamB",176,6,7035710,7037410,1700
"195","1901_10_TeamLJ_TeamB",181,4,7367859,7368909,1050
"196","1901_10_TeamLJ_TeamB",185,4,7620709,7621459,750
"197","1901_10_TeamLJ_TeamB",192,6,7981809,7982359,550
"198","1901_10_TeamLJ_TeamB",197,6,8106809,8107909,1100
"199","1901_10_TeamLJ_TeamB",214,4,8957508,8958558,1050
"200","1901_10_TeamLJ_TeamB",216,4,9133658,9134608,950
"201","1901_10_TeamLJ_TeamB",249,4,10225957,10227207,1250
"202","1901_11_TeamLJ_TeamB",71,5,2313094,2314244,1150
"203","1901_11_TeamLJ_TeamB",146,6,5354141,5355141,1000
"204","1901_11_TeamLJ_TeamB",153,4,5722041,5723591,1550
"205","1901_11_TeamLJ_TeamB",154,6,5765841,5767341,1500
"206","1901_11_TeamLJ_TeamB",164,4,6225590,6226740,1150
"207","1901_11_TeamLJ_TeamB",189,5,7093689,7095339,1650
"208","1901_11_TeamLJ_TeamB",193,6,7243989,7245239,1250
"209","1901_11_TeamLJ_TeamB",204,5,7700489,7701639,1150
"210","1901_11_TeamLJ_TeamB",220,6,8475488,8476988,1500
"211","1901_11_TeamLJ_TeamB",250,5,9466987,9468487,1500
"212","1901_11_TeamLJ_TeamB",282,6,10821336,10822136,800
"213","1901_11_TeamLJ_TeamB",296,6,11421035,11422135,1100
"214","1901_12_TeamLJ_TeamB",58,5,2049345,2050595,1250
"215","1901_12_TeamLJ_TeamB",83,6,2773894,2774394,500
"216","1901_12_TeamLJ_TeamB",139,4,4809642,4810342,700
"217","1901_12_TeamLJ_TeamB",215,5,7403890,7404890,1000
"218","1901_12_TeamLJ_TeamB",252,5,8650489,8651739,1250
"219","1901_12_TeamLJ_TeamB",263,6,9125188,9125938,750
"220","1901_12_TeamLJ_TeamB",268,4,9244738,9245338,600
"221","1901_12_TeamLJ_TeamB",269,4,9284038,9284888,850
"222","1901_13_TeamLL_TeamB",5,4,112925,114125,1200
"223","1901_13_TeamLL_TeamB",69,5,2132924,2134574,1650
"224","1901_13_TeamLL_TeamB",132,6,4051772,4052472,700
"225","1901_13_TeamLL_TeamB",136,5,4243872,4245022,1150
"226","1901_13_TeamLL_TeamB",140,6,4339421,4340921,1500
"227","1901_13_TeamLL_TeamB",183,4,6135520,6136720,1200
"228","1901_13_TeamLL_TeamB",193,4,6479069,6479869,800
"229","1901_13_TeamLL_TeamB",195,5,6691319,6692019,700
"230","1901_13_TeamLL_TeamB",204,4,6901069,6902369,1300
"231","1901_13_TeamLL_TeamB",233,6,8047518,8048418,900
"232","1901_14_TeamLL_TeamB",22,4,794701,795401,700
"233","1901_14_TeamLL_TeamB",85,5,2949049,2949799,750
"234","1901_14_TeamLL_TeamB",105,4,3636048,3636698,650
"235","1901_14_TeamLL_TeamB",199,5,7341295,7342145,850
"236","1901_14_TeamLL_TeamB",254,5,9217843,9219393,1550
"237","1901_15_TeamLL_TeamB",2,4,16921,18271,1350
"238","1901_15_TeamLL_TeamB",14,6,323021,324121,1100
"239","1901_15_TeamLL_TeamB",38,4,1258570,1259920,1350
"240","1901_15_TeamLL_TeamB",91,4,3010569,3011469,900
"241","1901_15_TeamLL_TeamB",137,6,4671117,4672117,1000
"242","1901_15_TeamLL_TeamB",172,6,6024616,6025816,1200
"243","1901_15_TeamLL_TeamB",213,4,7764564,7765514,950
"244","1901_15_TeamLL_TeamB",223,5,8070864,8072414,1550
"245","1901_15_TeamLL_TeamB",232,6,8429613,8430263,650
"246","1901_15_TeamLL_TeamB",248,4,9205113,9206163,1050
"247","1901_16_TeamLH_TeamA3",117,4,4045923,4046723,800
"248","1901_16_TeamLH_TeamA3",118,6,4088673,4089323,650
"249","1901_16_TeamLH_TeamA3",211,5,7386520,7387970,1450
"250","1901_16_TeamLH_TeamA3",214,4,7454770,7456420,1650
"251","1901_17_TeamLH_TeamA3",12,5,323044,323844,800
"252","1901_17_TeamLH_TeamA3",50,4,1470339,1471339,1000
"253","1901_17_TeamLH_TeamA3",61,6,1830038,1831488,1450
"254","1901_17_TeamLH_TeamA3",112,6,3607337,3608137,800
"255","1901_17_TeamLH_TeamA3",140,6,4532386,4533236,850
"256","1901_17_TeamLH_TeamA3",163,4,5238785,5239885,1100
"257","1901_17_TeamLH_TeamA3",174,6,5661385,5661935,550
"258","1901_17_TeamLH_TeamA3",188,6,6442034,6442834,800
"259","1901_17_TeamLH_TeamA3",260,5,9061881,9063331,1450
"260","1901_17_TeamLH_TeamA3",283,6,9877381,9877981,600
"261","1901_17_TeamLH_TeamA3",330,4,11593379,11594279,900
"262","1901_17_TeamLH_TeamA3",340,4,12083178,12083978,800
"263","1901_18_TeamLH_TeamA3",30,6,1055752,1056552,800
"264","1901_18_TeamLH_TeamA3",32,5,1101602,1103102,1500
"265","1901_18_TeamLH_TeamA3",252,6,8602645,8603745,1100
"266","1901_18_TeamLH_TeamA3",255,4,8798695,8799845,1150
"267","1901_18_TeamLH_TeamA3",275,4,9568494,9569794,1300
"268","1902_01_TeamMG_TeamA3",15,4,351593,352243,650
"269","1902_01_TeamMG_TeamA3",64,6,1966443,1967493,1050
"270","1902_01_TeamMG_TeamA3",169,6,5282243,5283193,950
"271","1902_01_TeamMG_TeamA3",189,4,5973693,5974543,850
"272","1902_02_TeamMG_TeamA3",68,4,2183769,2184519,750
"273","1902_02_TeamMG_TeamA3",79,6,2565169,2566269,1100
"274","1902_02_TeamMG_TeamA3",161,6,5580619,5581519,900
"275","1902_02_TeamMG_TeamA3",185,4,6357469,6358919,1450
"276","1902_02_TeamMG_TeamA3",249,5,8588669,8590019,1350
"277","1902_02_TeamMG_TeamA3",296,4,10142219,10143119,900
"278","1902_02_TeamMG_TeamA3",302,4,10308919,10309519,600
"279","1902_02_TeamMG_TeamA3",337,5,11515119,11516519,1400
"280","1902_02_TeamMG_TeamA3",341,4,11640569,11642119,1550
"281","1902_02_TeamMG_TeamA3",354,4,12108669,12109419,750
"282","1902_02_TeamMG_TeamA3",356,4,12278719,12279569,850
"283","1902_02_TeamMG_TeamA3",358,5,12325369,12326819,1450
"284","1902_03_TeamMG_TeamA3",15,4,472346,473196,850
"285","1902_03_TeamMG_TeamA3",16,6,624946,625696,750
"286","1902_03_TeamMG_TeamA3",24,5,803246,803896,650
"287","1902_03_TeamMG_TeamA3",53,5,1787396,1788796,1400
"288","1902_03_TeamMG_TeamA3",99,5,3187846,3189146,1300
"289","1902_03_TeamMG_TeamA3",102,5,3266446,3268496,2050
"290","1902_03_TeamMG_TeamA3",106,6,3475846,3477246,1400
"291","1902_03_TeamMG_TeamA3",122,6,3956746,3957596,850
"292","1902_03_TeamMG_TeamA3",126,5,4139546,4141346,1800
"293","1902_03_TeamMG_TeamA3",137,4,4453346,4454496,1150
"294","1902_03_TeamMG_TeamA3",200,4,7143146,7143546,400
"295","1902_03_TeamMG_TeamA3",230,4,8069196,8070496,1300
"296","1902_03_TeamMG_TeamA3",321,4,11555296,11555796,500
"297","1902_04_TeamML_TeamB",15,4,396834,397634,800
"298","1902_04_TeamML_TeamB",39,4,975934,977334,1400
"299","1902_04_TeamML_TeamB",40,6,1116034,1116934,900
"300","1902_04_TeamML_TeamB",43,5,1175784,1176334,550
"301","1902_04_TeamML_TeamB",53,5,1443334,1445034,1700
"302","1902_04_TeamML_TeamB",93,5,2821484,2822834,1350
"303","1902_04_TeamML_TeamB",104,6,3273334,3275084,1750
"304","1902_04_TeamML_TeamB",109,6,3378234,3378884,650
"305","1902_04_TeamML_TeamB",110,5,3524684,3526134,1450
"306","1902_04_TeamML_TeamB",135,6,4329834,4331084,1250
"307","1902_04_TeamML_TeamB",140,6,4448084,4449184,1100
"308","1902_04_TeamML_TeamB",158,6,5183034,5183834,800
"309","1902_04_TeamML_TeamB",165,4,5316434,5317034,600
"310","1902_04_TeamML_TeamB",192,5,6102134,6102634,500
"311","1902_04_TeamML_TeamB",205,6,6774484,6775884,1400
"312","1902_05_TeamML_TeamB",143,6,12243279,12244629,1350
"313","1902_05_TeamML_TeamB",145,4,12449879,12451229,1350
"314","1902_05_TeamML_TeamB",206,6,14562629,14563779,1150
"315","1902_05_TeamML_TeamB",214,4,14788429,14789829,1400
"316","1902_05_TeamML_TeamB",220,5,15101229,15103029,1800
"317","1902_05_TeamML_TeamB",276,4,17236879,17237729,850
"318","1902_06_TeamML_TeamB",22,5,692253,693653,1400
"319","1902_06_TeamML_TeamB",32,6,987403,987953,550
"320","1902_06_TeamML_TeamB",45,4,1374703,1375403,700
"321","1902_06_TeamML_TeamB",118,4,4152374,4153024,650
"322","1902_06_TeamML_TeamB",125,4,4406774,4408974,2200
"323","1902_06_TeamML_TeamB",191,4,6540974,6541474,500
"324","1902_06_TeamML_TeamB",267,6,9493024,9493874,850
"325","1902_06_TeamML_TeamB",288,6,10217174,10217674,500
"326","1902_07_TeamMJ_TeamB",76,4,2599902,2601252,1350
"327","1902_07_TeamMJ_TeamB",85,4,3003102,3004802,1700
"328","1902_07_TeamMJ_TeamB",93,4,3298902,3300352,1450
"329","1902_07_TeamMJ_TeamB",129,6,4571452,4572052,600
"330","1902_07_TeamMJ_TeamB",136,4,4905402,4906102,700
"331","1902_07_TeamMJ_TeamB",166,4,5969452,5969802,350
"332","1902_07_TeamMJ_TeamB",176,4,6377002,6377552,550
"333","1902_07_TeamMJ_TeamB",180,4,6472752,6473802,1050
"334","1902_07_TeamMJ_TeamB",195,6,7055252,7057002,1750
"335","1902_07_TeamMJ_TeamB",232,4,8587152,8588502,1350
"336","1902_07_TeamMJ_TeamB",237,6,8731152,8732202,1050
"337","1902_07_TeamMJ_TeamB",252,6,9306502,9307202,700
"338","1902_07_TeamMJ_TeamB",281,4,10567952,10569302,1350
"339","1902_07_TeamMJ_TeamB",288,5,10851902,10852752,850
"340","1902_08_TeamMJ_TeamB",108,6,3960344,3961744,1400
"341","1902_08_TeamMJ_TeamB",123,5,4407944,4409494,1550
"342","1902_08_TeamMJ_TeamB",133,4,4873194,4873894,700
"343","1902_08_TeamMJ_TeamB",160,4,6309694,6311044,1350
"344","1902_08_TeamMJ_TeamB",164,5,6411944,6413694,1750
"345","1902_08_TeamMJ_TeamB",227,6,8699944,8700644,700
"346","1902_08_TeamMJ_TeamB",230,4,8776794,8777494,700
"347","1902_08_TeamMJ_TeamB",316,4,12221955,12222555,600
"348","1902_08_TeamMJ_TeamB",318,6,12280905,12282055,1150
"349","1902_08_TeamMJ_TeamB",321,6,12362405,12363005,600
"350","1902_08_TeamMJ_TeamB",357,6,13677505,13678455,950
"351","1902_09_TeamMJ_TeamB",1,5,17805,18405,600
"352","1902_09_TeamMJ_TeamB",10,4,355405,356305,900
"353","1902_09_TeamMJ_TeamB",23,4,794755,795255,500
"354","1902_09_TeamMJ_TeamB",36,6,1146455,1147555,1100
"355","1902_09_TeamMJ_TeamB",184,5,6884455,6885705,1250
"356","1902_09_TeamMJ_TeamB",282,4,10702155,10703055,900
"357","1902_09_TeamMJ_TeamB",304,4,11431905,11433255,1350
"358","1902_09_TeamMJ_TeamB",312,6,11664855,11665855,1000
"359","1902_10_TeamMI_TeamA3",114,6,3943031,3943731,700
"360","1902_10_TeamMI_TeamA3",176,5,6331281,6332881,1600
"361","1902_10_TeamMI_TeamA3",229,5,8380181,8382081,1900
"362","1902_10_TeamMI_TeamA3",258,6,9487531,9488281,750
"363","1902_10_TeamMI_TeamA3",268,6,9872681,9873681,1000
"364","1902_10_TeamMI_TeamA3",282,6,10360181,10361281,1100
"365","1902_11_TeamMI_TeamA3",11,4,218402,219402,1000
"366","1902_11_TeamMI_TeamA3",70,6,2444252,2445902,1650
"367","1902_11_TeamMI_TeamA3",73,4,2509002,2510252,1250
"368","1902_11_TeamMI_TeamA3",144,6,4743852,4744752,900
"369","1902_11_TeamMI_TeamA3",175,4,5786652,5787902,1250
"370","1902_11_TeamMI_TeamA3",187,6,6239852,6240752,900
"371","1902_11_TeamMI_TeamA3",212,4,7180702,7181452,750
"372","1902_11_TeamMI_TeamA3",267,6,9467702,9469002,1300
"373","1902_12_TeamMI_TeamA3",13,6,302654,303604,950
"374","1902_12_TeamMI_TeamA3",71,4,2386454,2387854,1400
"375","1902_12_TeamMI_TeamA3",138,6,4692704,4693304,600
"376","1902_12_TeamMI_TeamA3",174,5,6078454,6079654,1200
"377","1902_12_TeamMI_TeamA3",196,5,7125554,7126154,600
"378","1902_12_TeamMI_TeamA3",208,4,7442804,7444004,1200
"379","1902_12_TeamMI_TeamA3",225,6,7936554,7937854,1300
"380","1902_12_TeamMI_TeamA3",240,4,8744854,8745704,850
"381","1902_12_TeamMI_TeamA3",260,6,9358454,9359354,900
"382","1902_12_TeamMI_TeamA3",266,5,9669204,9670804,1600
"383","1902_13_TeamMD_TeamA2",17,4,614130,615280,1150
"384","1902_13_TeamMD_TeamA2",20,4,758330,759080,750
"385","1902_13_TeamMD_TeamA2",44,6,1677130,1678830,1700
"386","1902_13_TeamMD_TeamA2",58,4,2130430,2130930,500
"387","1902_13_TeamMD_TeamA2",88,5,3238830,3241080,2250
"388","1902_13_TeamMD_TeamA2",91,4,3322080,3323230,1150
"389","1902_13_TeamMD_TeamA2",108,5,3926230,3928030,1800
"390","1902_13_TeamMD_TeamA2",248,6,8690130,8691530,1400
"391","1902_13_TeamMD_TeamA2",264,6,9060530,9061880,1350
"392","1902_13_TeamMD_TeamA2",318,6,11166830,11168580,1750
"393","1902_13_TeamMK_TeamB",4,4,72260,73010,750
"394","1902_13_TeamMK_TeamB",92,6,3415210,3415760,550
"395","1902_13_TeamMK_TeamB",108,4,3890710,3892160,1450
"396","1902_13_TeamMK_TeamB",112,6,4010010,4011110,1100
"397","1902_13_TeamMK_TeamB",130,5,4617460,4619310,1850
"398","1902_13_TeamMK_TeamB",240,6,9036310,9037410,1100
"399","1902_13_TeamMK_TeamB",282,4,10493310,10494210,900
"400","1902_13_TeamMK_TeamB",288,6,10669060,10669910,850
"401","1902_14_TeamMD_TeamA2",2,4,40897,42497,1600
"402","1902_14_TeamMD_TeamA2",27,4,847247,848147,900
"403","1902_14_TeamMD_TeamA2",66,6,2198326,2199776,1450
"404","1902_14_TeamMD_TeamA2",110,4,3515576,3516676,1100
"405","1902_14_TeamMD_TeamA2",121,5,3948376,3950376,2000
"406","1902_14_TeamMD_TeamA2",173,4,5601776,5602926,1150
"407","1902_14_TeamMD_TeamA2",192,4,6376428,6377678,1250
"408","1902_14_TeamMD_TeamA2",199,4,6688028,6689328,1300
"409","1902_14_TeamMD_TeamA2",245,6,8471915,8473465,1550
"410","1902_14_TeamMD_TeamA2",247,5,8529065,8531265,2200
"411","1902_14_TeamMD_TeamA2",280,5,9727415,9729215,1800
"412","1902_14_TeamMD_TeamA2",284,4,9838365,9839465,1100
"413","1902_14_TeamMD_TeamA2",314,4,10903265,10904015,750
"414","1902_14_TeamMD_TeamA2",327,6,11389815,11391415,1600
"415","1902_14_TeamMK_TeamB",9,6,198685,200085,1400
"416","1902_14_TeamMK_TeamB",26,6,844285,845085,800
"417","1902_14_TeamMK_TeamB",104,4,3323485,3325035,1550
"418","1902_14_TeamMK_TeamB",113,4,3625335,3626485,1150
"419","1902_14_TeamMK_TeamB",118,6,3756435,3757135,700
"420","1902_14_TeamMK_TeamB",160,6,5155985,5156785,800
"421","1902_14_TeamMK_TeamB",298,5,9800635,9802085,1450
"422","1902_15_TeamMK_TeamB",24,4,780964,781614,650
"423","1902_15_TeamMK_TeamB",40,5,1207214,1208764,1550
"424","1902_15_TeamMK_TeamB",53,4,1544364,1545564,1200
"425","1902_15_TeamMK_TeamB",93,4,3026014,3027264,1250
"426","1902_15_TeamMK_TeamB",99,5,3219614,3220314,700
"427","1902_15_TeamMK_TeamB",127,5,4211914,4212914,1000
"428","1902_15_TeamMK_TeamB",183,4,6143364,6144514,1150
"429","1902_15_TeamMK_TeamB",191,4,6487664,6488664,1000
"430","1902_15_TeamMK_TeamB",209,6,7206914,7207964,1050
"431","1902_15_TeamMK_TeamB",257,4,8903064,8904364,1300
"432","1902_15_TeamMK_TeamB",261,4,9171114,9172514,1400
"433","1902_16_TeamMD_TeamA2",24,4,676856,678206,1350
"434","1902_16_TeamMD_TeamA2",77,6,2525967,2526717,750
"435","1902_16_TeamMD_TeamA2",83,4,2836051,2836851,800
"436","1902_16_TeamMD_TeamA2",84,6,2869101,2870351,1250
"437","1902_16_TeamMD_TeamA2",90,6,3121801,3123001,1200
"438","1902_16_TeamMD_TeamA2",112,6,3866966,3867766,800
"439","1902_16_TeamMD_TeamA2",127,4,4431516,4432416,900
"440","1902_16_TeamMD_TeamA2",131,5,4536066,4537016,950
"441","1902_16_TeamMD_TeamA2",146,4,4924366,4925616,1250
"442","1902_16_TeamMD_TeamA2",149,5,5099566,5101116,1550
"443","1902_16_TeamMD_TeamA2",179,4,6037366,6038466,1100
"444","1902_16_TeamMD_TeamA2",189,6,6444566,6445616,1050
"445","1902_16_TeamMD_TeamA2",205,5,7178716,7180766,2050
"446","1902_16_TeamMD_TeamA2",237,5,8240616,8241666,1050
"447","1902_16_TeamMD_TeamA2",244,5,8487316,8489066,1750
"448","1902_16_TeamMD_TeamA2",265,4,9133966,9134516,550
"449","1902_17_TeamMB_TeamA1",2,4,54734,55984,1250
"450","1902_17_TeamMB_TeamA1",9,4,195534,196934,1400
"451","1902_17_TeamMB_TeamA1",38,4,1311284,1312234,950
"452","1902_17_TeamMB_TeamA1",54,5,1778234,1779534,1300
"453","1902_17_TeamMB_TeamA1",56,6,1836534,1837884,1350
"454","1902_17_TeamMB_TeamA1",57,6,1880134,1881284,1150
"455","1902_17_TeamMB_TeamA1",59,4,2043534,2045284,1750
"456","1902_17_TeamMB_TeamA1",80,4,2704934,2705634,700
"457","1902_17_TeamMB_TeamA1",99,4,3421320,3422220,900
"458","1902_17_TeamMB_TeamA1",102,6,3611870,3613070,1200
"459","1902_17_TeamMB_TeamA1",103,6,3640270,3641120,850
"460","1902_17_TeamMB_TeamA1",123,6,4552118,4553468,1350
"461","1902_17_TeamMB_TeamA1",129,6,4682668,4683218,550
"462","1902_17_TeamMB_TeamA1",202,4,7114332,7115132,800
"463","1902_17_TeamMB_TeamA1",246,4,8514182,8515632,1450
"464","1902_18_TeamMB_TeamA1",28,6,844654,845604,950
"465","1902_18_TeamMB_TeamA1",31,4,950504,951704,1200
"466","1902_18_TeamMB_TeamA1",48,4,1542004,1543304,1300
"467","1902_18_TeamMB_TeamA1",75,6,2719654,2720754,1100
"468","1902_18_TeamMB_TeamA1",86,5,2945604,2946704,1100
"469","1902_18_TeamMB_TeamA1",96,6,3464654,3465854,1200
"470","1902_18_TeamMB_TeamA1",112,4,3950604,3951504,900
"471","1902_18_TeamMB_TeamA1",146,4,5214104,5215454,1350
"472","1902_18_TeamMB_TeamA1",158,6,5741254,5742454,1200
"473","1902_18_TeamMB_TeamA1",190,5,6859104,6860754,1650
"474","1902_18_TeamMB_TeamA1",193,5,7112754,7113304,550
"475","1902_19_TeamME_TeamA2",23,5,533437,535237,1800
"476","1902_19_TeamME_TeamA2",24,6,742452,744002,1550
"477","1902_19_TeamME_TeamA2",62,4,2297752,2299352,1600
"478","1902_19_TeamME_TeamA2",154,6,5366502,5367852,1350
"479","1902_19_TeamME_TeamA2",161,5,5536802,5538052,1250
"480","1902_19_TeamME_TeamA2",182,6,6479802,6480302,500
"481","1902_19_TeamME_TeamA2",213,4,7574002,7575352,1350
"482","1902_19_TeamME_TeamA2",235,4,8277102,8278052,950
"483","1902_19_TeamME_TeamA2",243,4,8572852,8575102,2250
"484","1902_19_TeamME_TeamA2",261,4,9284202,9285252,1050
"485","1902_19_TeamME_TeamA2",280,4,9925402,9926652,1250
"486","1902_20_TeamME_TeamA2",8,6,197828,199028,1200
"487","1902_20_TeamME_TeamA2",34,6,1150328,1151028,700
"488","1902_20_TeamME_TeamA2",53,5,1832428,1833578,1150
"489","1902_20_TeamME_TeamA2",95,4,3251128,3252278,1150
"490","1902_20_TeamME_TeamA2",105,4,3747728,3749278,1550
"491","1902_20_TeamME_TeamA2",124,5,4385978,4386678,700
"492","1902_20_TeamME_TeamA2",129,4,4610528,4611428,900
"493","1902_20_TeamME_TeamA2",141,4,5009178,5010478,1300
"494","1902_20_TeamME_TeamA2",171,4,6308678,6309778,1100
"495","1902_20_TeamME_TeamA2",193,6,7094078,7095028,950
"496","1902_20_TeamME_TeamA2",198,6,7234978,7235378,400
"497","1902_20_TeamME_TeamA2",232,5,8860028,8861178,1150
"498","1902_21_TeamME_TeamA2",4,6,53608,54658,1050
"499","1902_21_TeamME_TeamA2",21,4,633908,634658,750
"500","1902_21_TeamME_TeamA2",33,6,904908,905608,700
"501","1902_21_TeamME_TeamA2",76,4,2686458,2688058,1600
"502","1902_21_TeamME_TeamA2",86,6,3091708,3093108,1400
"503","1902_21_TeamME_TeamA2",99,4,3610058,3611358,1300
"504","1902_21_TeamME_TeamA2",111,6,4020858,4021558,700
"505","1902_21_TeamME_TeamA2",141,4,4887358,4888608,1250
"506","1902_21_TeamME_TeamA2",143,5,5064408,5065458,1050
"507","1902_21_TeamME_TeamA2",174,4,6306108,6307208,1100
"508","1902_21_TeamME_TeamA2",187,5,6923808,6925458,1650
"509","1902_22_TeamMA_TeamA1",75,4,2638540,2639040,500
"510","1902_22_TeamMA_TeamA1",84,6,3054240,3054840,600
"511","1902_22_TeamMA_TeamA1",104,4,3681740,3682640,900
"512","1902_22_TeamMA_TeamA1",155,4,5519840,5521240,1400
"513","1902_22_TeamMA_TeamA1",157,5,5679790,5681840,2050
"514","1902_22_TeamMA_TeamA1",161,4,5780040,5781190,1150
"515","1902_22_TeamMA_TeamA1",164,6,5859040,5860240,1200
"516","1902_22_TeamMA_TeamA1",182,6,6391390,6392290,900
"517","1902_22_TeamMA_TeamA1",193,6,6793790,6794440,650
"518","1902_22_TeamMA_TeamA1",195,5,6840940,6841540,600
"519","1902_22_TeamMA_TeamA1",249,4,8903090,8903940,850
"520","1902_23_TeamMA_TeamA1",3,4,42588,43088,500
"521","1902_23_TeamMA_TeamA1",6,4,104788,106138,1350
"522","1902_23_TeamMA_TeamA1",31,6,883088,884288,1200
"523","1902_23_TeamMA_TeamA1",39,6,1212338,1213138,800
"524","1902_23_TeamMA_TeamA1",130,4,4377088,4378388,1300
"525","1902_23_TeamMA_TeamA1",152,6,5080488,5081488,1000
"526","1902_23_TeamMA_TeamA1",221,4,7739388,7740138,750
"527","1902_23_TeamMA_TeamA1",222,4,8083288,8083838,550
"528","1902_23_TeamMA_TeamA1",255,4,9313938,9314738,800
"529","1902_24_TeamMA_TeamA1",10,5,260627,262376,1749
"530","1902_24_TeamMA_TeamA1",14,4,383981,384839,858
"531","1902_24_TeamMA_TeamA1",27,6,779486,780443,957
"532","1902_24_TeamMA_TeamA1",58,6,1813872,1815621,1749
"533","1902_24_TeamMA_TeamA1",65,4,1980918,1981677,759
"534","1902_24_TeamMA_TeamA1",74,4,2318245,2318971,726
"535","1902_24_TeamMA_TeamA1",76,4,2365897,2367382,1485
"536","1902_24_TeamMA_TeamA1",85,5,2599933,2600956,1023
"537","1902_24_TeamMA_TeamA1",141,6,4736409,4737894,1485
"538","1902_24_TeamMA_TeamA1",234,5,8047830,8048952,1122
"539","1902_24_TeamMA_TeamA1",240,6,8241705,8243124,1419
"540","1902_24_TeamMA_TeamA1",278,6,9526232,9527387,1155
"541","1902_24_TeamMA_TeamA1",283,5,9762908,9764624,1716
"542","1902_24_TeamMA_TeamA1",284,6,9800165,9800891,726
"543","1902_24_TeamMA_TeamA1",327,6,11473200,11474124,924
"544","1902_25_TeamMH_TeamA3",79,5,2443512,2444212,700
"545","1902_25_TeamMH_TeamA3",87,5,2605012,2606462,1450
"546","1902_25_TeamMH_TeamA3",122,4,3892962,3893762,800
"547","1902_25_TeamMH_TeamA3",126,5,3988812,3990362,1550
"548","1902_25_TeamMH_TeamA3",151,4,4894312,4895062,750
"549","1902_25_TeamMH_TeamA3",157,6,5040862,5042112,1250
"550","1902_25_TeamMH_TeamA3",169,5,5463612,5465212,1600
"551","1902_25_TeamMH_TeamA3",322,6,10474747,10475397,650
"552","1902_26_TeamMC_TeamA1",8,6,606177,606877,700
"553","1902_26_TeamMC_TeamA1",48,4,1882327,1883177,850
"554","1902_26_TeamMC_TeamA1",56,6,2077877,2079077,1200
"555","1902_26_TeamMC_TeamA1",115,5,4016327,4017827,1500
"556","1902_26_TeamMC_TeamA1",120,6,4221277,4221977,700
"557","1902_26_TeamMC_TeamA1",188,4,6548677,6550577,1900
"558","1902_26_TeamMC_TeamA1",199,6,7013427,7013977,550
"559","1902_26_TeamMC_TeamA1",204,5,7284477,7286127,1650
"560","1902_26_TeamMC_TeamA1",230,5,8073627,8074727,1100
"561","1902_26_TeamMC_TeamA1",254,5,8977277,8977927,650
"562","1902_26_TeamMH_TeamA3",4,5,69106,70306,1200
"563","1902_26_TeamMH_TeamA3",99,5,3113706,3115556,1850
"564","1902_26_TeamMH_TeamA3",111,6,3509106,3510006,900
"565","1902_26_TeamMH_TeamA3",130,4,4129256,4130356,1100
"566","1902_26_TeamMH_TeamA3",156,5,5064856,5066706,1850
"567","1902_26_TeamMH_TeamA3",166,4,5460306,5461656,1350
"568","1902_26_TeamMH_TeamA3",202,6,6690556,6691506,950
"569","1902_26_TeamMH_TeamA3",254,6,8671358,8672008,650
"570","1902_26_TeamMH_TeamA3",260,6,8853708,8855108,1400
"571","1902_26_TeamMH_TeamA3",291,4,9972308,9973158,850
"572","1902_26_TeamMH_TeamA3",297,4,10128808,10129858,1050
"573","1902_27_TeamMH_TeamA3",57,4,1856122,1857072,950
"574","1902_27_TeamMH_TeamA3",191,5,6673972,6675872,1900
"575","1902_27_TeamMH_TeamA3",265,5,8906822,8907522,700
"576","1902_27_TeamMH_TeamA3",282,4,9566022,9567272,1250
"577","1902_28_TeamMC_TeamA1",16,5,619355,620705,1350
"578","1902_28_TeamMC_TeamA1",28,4,1004905,1005955,1050
"579","1902_28_TeamMC_TeamA1",44,4,1650555,1651405,850
"580","1902_28_TeamMC_TeamA1",57,4,2085105,2086005,900
"581","1902_28_TeamMC_TeamA1",71,4,2530305,2531655,1350
"582","1902_28_TeamMC_TeamA1",149,4,5550705,5551255,550
"583","1902_28_TeamMC_TeamA1",167,4,6139505,6140205,700
"584","1902_28_TeamMC_TeamA1",179,5,6607355,6608355,1000
"585","1902_28_TeamMC_TeamA1",192,4,7082955,7084555,1600
"586","1902_29_TeamMF_TeamA2",5,6,112818,114268,1450
"587","1902_29_TeamMF_TeamA2",15,5,512368,513468,1100
"588","1902_29_TeamMF_TeamA2",20,4,640818,641668,850
"589","1902_29_TeamMF_TeamA2",24,4,850768,851818,1050
"590","1902_29_TeamMF_TeamA2",30,4,972868,974368,1500
"591","1902_29_TeamMF_TeamA2",47,4,1571668,1572418,750
"592","1902_29_TeamMF_TeamA2",95,6,3778310,3779460,1150
"593","1902_29_TeamMF_TeamA2",132,6,5299610,5301060,1450
"594","1902_29_TeamMF_TeamA2",136,5,5394110,5395610,1500
"595","1902_29_TeamMF_TeamA2",159,5,6252910,6254310,1400
"596","1902_29_TeamMF_TeamA2",160,4,6286960,6288260,1300
"597","1902_29_TeamMF_TeamA2",222,5,8666860,8668310,1450
"598","1902_30_TeamMF_TeamA2",20,5,474350,476000,1650
"599","1902_30_TeamMF_TeamA2",29,6,907104,907654,550
"600","1902_30_TeamMF_TeamA2",37,4,1189104,1189954,850
"601","1902_30_TeamMF_TeamA2",150,4,4861729,4863579,1850
"602","1902_30_TeamMF_TeamA2",155,4,5212479,5213579,1100
"603","1902_30_TeamMF_TeamA2",178,4,6065329,6066329,1000
"604","1902_30_TeamMF_TeamA2",194,5,6723079,6723779,700
"605","1902_30_TeamMF_TeamA2",227,6,7853579,7854379,800
"606","1902_30_TeamMF_TeamA2",248,6,8590479,8590979,500
"607","1902_30_TeamMF_TeamA2",273,4,9496379,9497429,1050
"608","1902_30_TeamMF_TeamA2",320,4,11418164,11419014,850
"609","1902_31_TeamMF_TeamA2",19,5,520346,521546,1200
"610","1902_31_TeamMF_TeamA2",35,4,976246,977596,1350
"611","1902_31_TeamMF_TeamA2",66,6,1860696,1861796,1100
"612","1902_31_TeamMF_TeamA2",71,4,1964196,1965246,1050
"613","1902_31_TeamMF_TeamA2",188,6,5959246,5960746,1500
"614","1902_31_TeamMF_TeamA2",203,4,6460146,6461596,1450
"615","1902_31_TeamMF_TeamA2",245,6,7942046,7943646,1600
"616","1902_31_TeamMF_TeamA2",287,6,9336846,9338796,1950
"617","1903_01_TeamNE_TeamA2",18,6,460212,461301,1089
"618","1903_01_TeamNE_TeamA2",38,5,1092459,1094175,1716
"619","1903_01_TeamNE_TeamA2",58,6,1616896,1618117,1221
"620","1903_01_TeamNE_TeamA2",117,6,3638082,3639039,957
"621","1903_01_TeamNE_TeamA2",119,6,3794238,3795327,1089
"622","1903_01_TeamNE_TeamA2",185,4,6119948,6121268,1320
"623","1903_01_TeamNE_TeamA2",260,4,8667386,8668772,1386
"624","1903_01_TeamNE_TeamA2",326,5,10931419,10932706,1287
"625","1903_02_TeamNE_TeamA2",42,4,1202325,1203525,1200
"626","1903_02_TeamNE_TeamA2",46,6,1409175,1410325,1150
"627","1903_02_TeamNE_TeamA2",49,5,1491375,1492975,1600
"628","1903_02_TeamNE_TeamA2",55,5,1693175,1694175,1000
"629","1903_02_TeamNE_TeamA2",62,6,2163591,2164841,1250
"630","1903_02_TeamNE_TeamA2",72,6,3221587,3222287,700
"631","1903_02_TeamNE_TeamA2",96,6,4104537,4105237,700
"632","1903_02_TeamNE_TeamA2",138,6,5684337,5685537,1200
"633","1903_02_TeamNE_TeamA2",141,4,5755537,5757087,1550
"634","1903_02_TeamNE_TeamA2",147,4,5907887,5908887,1000
"635","1903_02_TeamNE_TeamA2",151,5,6073137,6074837,1700
"636","1903_02_TeamNE_TeamA2",152,6,6104587,6105737,1150
"637","1903_02_TeamNE_TeamA2",168,5,6555787,6557387,1600
"638","1903_02_TeamNE_TeamA2",171,5,6759837,6761137,1300
"639","1903_02_TeamNE_TeamA2",194,6,7422387,7423137,750
"640","1903_03_TeamNE_TeamA2",36,6,985678,986528,850
"641","1903_03_TeamNE_TeamA2",52,6,1381528,1382178,650
"642","1903_03_TeamNE_TeamA2",55,4,1433078,1433928,850
"643","1903_03_TeamNE_TeamA2",62,4,1729028,1730478,1450
"644","1903_03_TeamNE_TeamA2",90,5,2604678,2605278,600
"645","1903_03_TeamNE_TeamA2",96,6,2731578,2733478,1900
"646","1903_03_TeamNE_TeamA2",128,5,3630978,3631678,700
"647","1903_03_TeamNE_TeamA2",148,4,4335328,4336028,700
"648","1903_03_TeamNE_TeamA2",166,6,5037728,5038778,1050
"649","1903_03_TeamNE_TeamA2",173,5,5189178,5190528,1350
"650","1903_03_TeamNE_TeamA2",176,4,5363678,5364728,1050
"651","1903_03_TeamNE_TeamA2",214,5,6773428,6774728,1300
"652","1903_03_TeamNE_TeamA2",231,5,7385728,7386728,1000
"653","1903_04_TeamNC_TeamA1",25,4,841619,843069,1450
"654","1903_04_TeamNC_TeamA1",67,5,2383419,2384919,1500
"655","1903_04_TeamNC_TeamA1",109,4,3906619,3908219,1600
"656","1903_04_TeamNC_TeamA1",111,5,3958669,3959669,1000
"657","1903_04_TeamNC_TeamA1",121,5,4379269,4380319,1050
"658","1903_04_TeamNC_TeamA1",144,5,5139769,5140519,750
"659","1903_05_TeamND_TeamA2",57,4,1546612,1548562,1950
"660","1903_05_TeamND_TeamA2",190,4,5914162,5915112,950
"661","1903_05_TeamND_TeamA2",193,4,6019812,6020562,750
"662","1903_05_TeamND_TeamA2",204,4,6460962,6462462,1500
"663","1903_05_TeamND_TeamA2",280,4,9099312,9100462,1150
"664","1903_05_TeamND_TeamA2",297,6,9644462,9645712,1250
"665","1903_06_TeamND_TeamA2",17,6,462524,463274,750
"666","1903_06_TeamND_TeamA2",29,4,820324,821874,1550
"667","1903_06_TeamND_TeamA2",36,6,1059374,1060774,1400
"668","1903_06_TeamND_TeamA2",88,6,2746624,2747574,950
"669","1903_06_TeamND_TeamA2",93,6,2888174,2889224,1050
"670","1903_06_TeamND_TeamA2",123,4,3951724,3952974,1250
"671","1903_06_TeamND_TeamA2",157,5,5154274,5155474,1200
"672","1903_06_TeamND_TeamA2",207,6,6961374,6962224,850
"673","1903_06_TeamND_TeamA2",248,6,8341674,8342274,600
"674","1903_07_TeamND_TeamA2",74,6,2104323,2104923,600
"675","1903_07_TeamND_TeamA2",81,5,2240223,2241623,1400
"676","1903_07_TeamND_TeamA2",110,4,3209723,3210523,800
"677","1903_07_TeamND_TeamA2",120,4,3550873,3551923,1050
"678","1903_07_TeamND_TeamA2",125,4,3679273,3680923,1650
"679","1903_07_TeamND_TeamA2",290,6,9484573,9485773,1200
"680","1903_07_TeamND_TeamA2",313,4,10392073,10392773,700
"681","1903_07_TeamND_TeamA2",322,4,10779073,10780373,1300
"682","1903_08_TeamNJ_TeamB",37,4,1171817,1172967,1150
"683","1903_08_TeamNJ_TeamB",54,4,1852267,1853417,1150
"684","1903_08_TeamNJ_TeamB",64,6,2156517,2157467,950
"685","1903_08_TeamNJ_TeamB",90,5,3041067,3042117,1050
"686","1903_08_TeamNJ_TeamB",101,4,3418567,3419067,500
"687","1903_08_TeamNJ_TeamB",103,6,3570417,3571017,600
"688","1903_08_TeamNJ_TeamB",107,4,3650617,3651467,850
"689","1903_08_TeamNJ_TeamB",111,5,3870567,3872567,2000
"690","1903_08_TeamNJ_TeamB",124,5,4255267,4257267,2000
"691","1903_08_TeamNJ_TeamB",133,6,4620267,4622167,1900
"692","1903_08_TeamNJ_TeamB",173,4,6133517,6134917,1400
"693","1903_08_TeamNJ_TeamB",175,4,6304617,6305267,650
"694","1903_08_TeamNJ_TeamB",190,6,6785667,6786567,900
"695","1903_08_TeamNJ_TeamB",192,6,6847767,6849067,1300
"696","1903_08_TeamNJ_TeamB",213,5,7644017,7644567,550
"697","1903_08_TeamNJ_TeamB",218,6,7810767,7811617,850
"698","1903_08_TeamNJ_TeamB",232,6,8366817,8367617,800
"699","1903_08_TeamNJ_TeamB",234,6,8417417,8418367,950
"700","1903_09_TeamNJ_TeamB",15,6,343484,344834,1350
"701","1903_09_TeamNJ_TeamB",50,4,1484634,1485934,1300
"702","1903_09_TeamNJ_TeamB",58,4,1729084,1730134,1050
"703","1903_09_TeamNJ_TeamB",60,5,2382515,2383415,900
"704","1903_09_TeamNJ_TeamB",110,5,4064215,4065915,1700
"705","1903_09_TeamNJ_TeamB",133,4,4918815,4920115,1300
"706","1903_09_TeamNJ_TeamB",173,4,6617115,6617865,750
"707","1903_09_TeamNJ_TeamB",186,4,7207415,7208115,700
"708","1903_09_TeamNJ_TeamB",193,5,7467015,7468315,1300
"709","1903_09_TeamNJ_TeamB",211,4,8130265,8131015,750
"710","1903_09_TeamNJ_TeamB",249,6,9586165,9587415,1250
"711","1903_09_TeamNJ_TeamB",263,4,10133265,10134965,1700
"712","1903_10_TeamNJ_TeamB",12,4,459739,460339,600
"713","1903_10_TeamNJ_TeamB",18,4,624139,624689,550
"714","1903_10_TeamNJ_TeamB",38,6,1304539,1305639,1100
"715","1903_10_TeamNJ_TeamB",67,5,2268389,2270289,1900
"716","1903_10_TeamNJ_TeamB",73,6,2551289,2552089,800
"717","1903_10_TeamNJ_TeamB",95,4,3318689,3319739,1050
"718","1903_10_TeamNJ_TeamB",137,4,4689989,4690539,550
"719","1903_10_TeamNJ_TeamB",200,4,7050722,7051422,700
"720","1903_10_TeamNJ_TeamB",230,5,8037822,8039072,1250
"721","1903_11_TeamNC_TeamA1",52,4,1707650,1709650,2000
"722","1903_11_TeamNC_TeamA1",59,6,1991100,1992100,1000
"723","1903_11_TeamNC_TeamA1",90,4,2970250,2971150,900
"724","1903_11_TeamNC_TeamA1",98,4,8602086,8603086,1000
"725","1903_11_TeamNC_TeamA1",110,4,9098486,9099286,800
"726","1903_11_TeamNC_TeamA1",188,5,11732336,11734336,2000
"727","1903_11_TeamNC_TeamA1",193,4,11956536,11957736,1200
"728","1903_11_TeamNC_TeamA1",200,4,12241436,12242436,1000
"729","1903_11_TeamNC_TeamA1",231,5,13505136,13506236,1100
"730","1903_11_TeamNC_TeamA1",259,4,14537736,14539286,1550
"731","1903_11_TeamNC_TeamA1",263,5,14625086,14626236,1150
"732","1903_11_TeamNC_TeamA1",264,6,14748836,14749636,800
"733","1903_12_TeamNC_TeamA1",24,4,744698,746248,1550
"734","1903_12_TeamNC_TeamA1",35,5,1072848,1074348,1500
"735","1903_12_TeamNC_TeamA1",81,4,2625554,2626804,1250
"736","1903_12_TeamNC_TeamA1",100,5,3277254,3278154,900
"737","1903_12_TeamNC_TeamA1",115,4,3773254,3774004,750
"738","1903_12_TeamNC_TeamA1",121,4,3881404,3882104,700
"739","1903_12_TeamNC_TeamA1",130,4,4266954,4268804,1850
"740","1903_12_TeamNC_TeamA1",208,6,7572404,7573204,800
"741","1903_12_TeamNC_TeamA1",218,4,7983154,7983904,750
"742","1903_12_TeamNC_TeamA1",237,6,8704754,8706054,1300
"743","1903_13_TeamNG_TeamA3",49,4,1461084,1462534,1450
"744","1903_13_TeamNG_TeamA3",56,4,1775784,1776684,900
"745","1903_13_TeamNG_TeamA3",60,6,1865534,1866234,700
"746","1903_13_TeamNG_TeamA3",207,4,6886684,6887334,650
"747","1903_13_TeamNG_TeamA3",255,4,8799684,8800634,950
"748","1903_14_TeamNG_TeamA3",9,5,188932,190582,1650
"749","1903_14_TeamNG_TeamA3",13,6,423332,424032,700
"750","1903_14_TeamNG_TeamA3",45,4,1394132,1394882,750
"751","1903_14_TeamNG_TeamA3",56,5,1712182,1713182,1000
"752","1903_14_TeamNG_TeamA3",84,4,2779622,2780622,1000
"753","1903_14_TeamNG_TeamA3",137,6,5289032,5289932,900
"754","1903_14_TeamNG_TeamA3",192,4,7476621,7477471,850
"755","1903_14_TeamNG_TeamA3",233,4,9008868,9010168,1300
"756","1903_14_TeamNG_TeamA3",246,6,9517618,9518218,600
"757","1903_15_TeamNG_TeamA3",41,6,1386319,1387119,800
"758","1903_15_TeamNG_TeamA3",47,6,1527869,1529269,1400
"759","1903_15_TeamNG_TeamA3",88,6,2744269,2745069,800
"760","1903_15_TeamNG_TeamA3",114,4,3722919,3724319,1400
"761","1903_15_TeamNG_TeamA3",117,6,3819219,3819819,600
"762","1903_15_TeamNG_TeamA3",147,4,4802069,4802919,850
"763","1903_15_TeamNG_TeamA3",158,6,5319169,5320069,900
"764","1903_15_TeamNG_TeamA3",243,4,8044869,8046069,1200
"765","1903_15_TeamNG_TeamA3",271,4,9298169,9298719,550
"766","1903_15_TeamNG_TeamA3",293,4,10036969,10038019,1050
"767","1903_16_TeamNI_TeamA3",25,6,738168,739218,1050
"768","1903_16_TeamNI_TeamA3",82,5,2514968,2516768,1800
"769","1903_16_TeamNI_TeamA3",96,6,2970318,2971518,1200
"770","1903_16_TeamNI_TeamA3",141,6,4505668,4506768,1100
"771","1903_16_TeamNI_TeamA3",162,5,5181518,5182318,800
"772","1903_16_TeamNI_TeamA3",177,4,5673418,5674968,1550
"773","1903_16_TeamNI_TeamA3",219,4,6927268,6928618,1350
"774","1903_16_TeamNI_TeamA3",276,6,8891321,8892321,1000
"775","1903_17_TeamNI_TeamA3",6,6,83769,84869,1100
"776","1903_17_TeamNI_TeamA3",43,4,1425383,1427233,1850
"777","1903_17_TeamNI_TeamA3",84,4,2835933,2837583,1650
"778","1903_17_TeamNI_TeamA3",98,5,3511663,3513363,1700
"779","1903_17_TeamNI_TeamA3",109,4,3965213,3966013,800
"780","1903_17_TeamNI_TeamA3",121,4,4486863,4488513,1650
"781","1903_17_TeamNI_TeamA3",138,4,4948363,4948963,600
"782","1903_17_TeamNI_TeamA3",193,4,6971113,6972763,1650
"783","1903_17_TeamNI_TeamA3",203,6,7281663,7282813,1150
"784","1903_17_TeamNI_TeamA3",228,6,7994513,7995063,550
"785","1903_17_TeamNI_TeamA3",235,4,8244963,8246363,1400
"786","1903_17_TeamNI_TeamA3",237,5,8289863,8291563,1700
"787","1903_17_TeamNI_TeamA3",255,5,8956157,8957607,1450
"788","1903_18_TeamNI_TeamA3",41,5,1268631,1269731,1100
"789","1903_18_TeamNI_TeamA3",46,4,1369981,1371731,1750
"790","1903_18_TeamNI_TeamA3",50,4,1584131,1585831,1700
"791","1903_18_TeamNI_TeamA3",57,6,1828831,1830381,1550
"792","1903_18_TeamNI_TeamA3",79,6,2453681,2454831,1150
"793","1903_18_TeamNI_TeamA3",81,5,2499831,2500681,850
"794","1903_18_TeamNI_TeamA3",103,4,3279731,3280931,1200
"795","1903_18_TeamNI_TeamA3",123,4,3891531,3893081,1550
"796","1903_18_TeamNI_TeamA3",134,4,4220731,4221381,650
"797","1903_18_TeamNI_TeamA3",154,5,4873081,4874131,1050
"798","1903_18_TeamNI_TeamA3",225,6,7474281,7475531,1250
"799","1903_18_TeamNI_TeamA3",251,6,8434531,8435731,1200
"800","1903_19_TeamNL_TeamB",11,6,276201,277001,800
"801","1903_19_TeamNL_TeamB",14,6,359451,361551,2100
"802","1903_19_TeamNL_TeamB",23,6,712751,713701,950
"803","1903_19_TeamNL_TeamB",48,4,1486901,1488151,1250
"804","1903_19_TeamNL_TeamB",58,4,1820251,1820601,350
"805","1903_19_TeamNL_TeamB",67,4,2125451,2126151,700
"806","1903_19_TeamNL_TeamB",74,6,2373751,2374401,650
"807","1903_19_TeamNL_TeamB",89,4,2876151,2876951,800
"808","1903_19_TeamNL_TeamB",151,4,5141951,5142701,750
"809","1903_19_TeamNL_TeamB",194,5,6681401,6682001,600
"810","1903_19_TeamNL_TeamB",264,6,8979001,8980251,1250
"811","1903_19_TeamNL_TeamB",265,6,9013301,9013901,600
"812","1903_19_TeamNL_TeamB",272,6,9170501,9171201,700
"813","1903_20_TeamNL_TeamB",9,6,217932,219082,1150
"814","1903_20_TeamNL_TeamB",16,5,511832,512882,1050
"815","1903_20_TeamNL_TeamB",31,4,1204866,1206416,1550
"816","1903_20_TeamNL_TeamB",65,4,2351366,2351966,600
"817","1903_20_TeamNL_TeamB",102,4,3380366,3381616,1250
"818","1903_20_TeamNL_TeamB",124,5,4093466,4095316,1850
"819","1903_20_TeamNL_TeamB",131,4,4217466,4218866,1400
"820","1903_20_TeamNL_TeamB",188,4,6367216,6368066,850
"821","1903_20_TeamNL_TeamB",196,4,6678316,6680066,1750
"822","1903_20_TeamNL_TeamB",220,4,7623466,7624816,1350
"823","1903_20_TeamNL_TeamB",224,4,7704566,7705266,700
"824","1903_20_TeamNL_TeamB",245,6,8499216,8500666,1450
"825","1903_21_TeamNL_TeamB",36,5,1109808,1111608,1800
"826","1903_21_TeamNL_TeamB",39,6,1175508,1176358,850
"827","1903_21_TeamNL_TeamB",62,5,1918158,1919758,1600
"828","1903_21_TeamNL_TeamB",74,6,2385908,2386508,600
"829","1903_21_TeamNL_TeamB",101,6,3348708,3350108,1400
"830","1903_21_TeamNL_TeamB",105,6,3456608,3458108,1500
"831","1903_21_TeamNL_TeamB",132,6,4525358,4526908,1550
"832","1903_21_TeamNL_TeamB",139,5,4828058,4829508,1450
"833","1903_21_TeamNL_TeamB",167,4,5815758,5816958,1200
"834","1903_21_TeamNL_TeamB",172,4,5952508,5953608,1100
"835","1903_22_TeamNA_TeamA1",4,4,69313,70513,1200
"836","1903_22_TeamNA_TeamA1",20,4,555513,556763,1250
"837","1903_22_TeamNA_TeamA1",52,6,1446613,1447863,1250
"838","1903_22_TeamNA_TeamA1",76,4,2148513,2150063,1550
"839","1903_22_TeamNA_TeamA1",135,4,3826313,3826913,600
"840","1903_22_TeamNA_TeamA1",152,6,4393813,4394463,650
"841","1903_22_TeamNA_TeamA1",225,4,6869513,6870313,800
"842","1903_22_TeamNA_TeamA1",246,4,7651663,7653313,1650
"843","1903_23_TeamNA_TeamA1",26,4,673010,674610,1600
"844","1903_23_TeamNA_TeamA1",29,6,729660,730210,550
"845","1903_23_TeamNA_TeamA1",46,5,1232610,1233560,950
"846","1903_23_TeamNA_TeamA1",67,4,2019694,2021044,1350
"847","1903_23_TeamNA_TeamA1",110,4,3544494,3546194,1700
"848","1903_23_TeamNA_TeamA1",115,4,3672994,3674094,1100
"849","1903_23_TeamNA_TeamA1",140,4,4398894,4399694,800
"850","1903_23_TeamNA_TeamA1",254,4,8029194,8030344,1150
"851","1903_23_TeamNA_TeamA1",273,6,8582544,8583694,1150
"852","1903_24_TeamNA_TeamA1",57,4,1763269,1763719,450
"853","1903_24_TeamNA_TeamA1",60,4,1816569,1817469,900
"854","1903_24_TeamNA_TeamA1",108,4,3339019,3340469,1450
"855","1903_24_TeamNA_TeamA1",123,6,3893419,3894269,850
"856","1903_24_TeamNA_TeamA1",142,4,4482669,4484019,1350
"857","1903_24_TeamNA_TeamA1",147,4,4579019,4579919,900
"858","1903_24_TeamNA_TeamA1",156,5,4904269,4904969,700
"859","1903_24_TeamNA_TeamA1",168,5,5414869,5416119,1250
"860","1903_24_TeamNA_TeamA1",207,5,6741969,6743769,1800
"861","1903_25_TeamNH_TeamA3",39,4,1188561,1189711,1150
"862","1903_25_TeamNH_TeamA3",67,4,2133761,2134811,1050
"863","1903_25_TeamNH_TeamA3",76,4,2490761,2492311,1550
"864","1903_25_TeamNH_TeamA3",111,5,3649461,3650161,700
"865","1903_25_TeamNH_TeamA3",113,6,3797661,3798311,650
"866","1903_25_TeamNH_TeamA3",151,6,5231061,5231761,700
"867","1903_25_TeamNH_TeamA3",166,4,5693411,5694361,950
"868","1903_25_TeamNH_TeamA3",224,4,8022411,8023911,1500
"869","1903_25_TeamNH_TeamA3",241,6,8612911,8613911,1000
"870","1903_25_TeamNH_TeamA3",259,6,9345711,9346661,950
"871","1903_25_TeamNK_TeamB",3,4,81815,83165,1350
"872","1903_25_TeamNK_TeamB",50,5,1811215,1812565,1350
"873","1903_25_TeamNK_TeamB",77,5,2804115,2806065,1950
"874","1903_25_TeamNK_TeamB",118,4,4310565,4311915,1350
"875","1903_25_TeamNK_TeamB",120,6,4479065,4480115,1050
"876","1903_25_TeamNK_TeamB",149,6,5464815,5465365,550
"877","1903_25_TeamNK_TeamB",156,6,5811515,5811965,450
"878","1903_25_TeamNK_TeamB",179,4,6923665,6924265,600
"879","1903_25_TeamNK_TeamB",184,5,7189365,7190965,1600
"880","1903_25_TeamNK_TeamB",188,5,7273815,7275465,1650
"881","1903_25_TeamNK_TeamB",219,4,8599615,8600815,1200
"882","1903_25_TeamNK_TeamB",237,5,9069415,9071615,2200
"883","1903_25_TeamNK_TeamB",258,4,9960315,9961215,900
"884","1903_26_TeamNH_TeamA3",7,4,167713,168363,650
"885","1903_26_TeamNH_TeamA3",58,4,1832913,1833713,800
"886","1903_26_TeamNH_TeamA3",83,4,2670263,2671563,1300
"887","1903_26_TeamNH_TeamA3",197,4,6467063,6468513,1450
"888","1903_26_TeamNH_TeamA3",255,5,8690763,8692663,1900
"889","1903_26_TeamNH_TeamA3",278,6,9653163,9654863,1700
"890","1903_26_TeamNH_TeamA3",284,4,9818113,9819813,1700
"891","1903_26_TeamNH_TeamA3",340,5,11997363,11998313,950
"892","1903_26_TeamNK_TeamB",10,5,360510,361060,550
"893","1903_26_TeamNK_TeamB",26,4,849279,850429,1150
"894","1903_26_TeamNK_TeamB",42,4,1300929,1302129,1200
"895","1903_26_TeamNK_TeamB",59,6,1823229,1824379,1150
"896","1903_26_TeamNK_TeamB",74,5,2276129,2277779,1650
"897","1903_26_TeamNK_TeamB",76,6,2330979,2331629,650
"898","1903_26_TeamNK_TeamB",118,6,3772179,3773229,1050
"899","1903_26_TeamNK_TeamB",174,5,5758329,5760629,2300
"900","1903_26_TeamNK_TeamB",183,6,5989779,5990829,1050
"901","1903_26_TeamNK_TeamB",193,5,6403029,6403579,550
"902","1903_26_TeamNK_TeamB",199,4,6762679,6763479,800
"903","1903_26_TeamNK_TeamB",237,6,8090229,8091379,1150
"904","1903_26_TeamNK_TeamB",239,6,8150929,8151629,700
"905","1903_27_TeamNH_TeamA3",24,4,700807,701957,1150
"906","1903_27_TeamNH_TeamA3",50,6,1614157,1615507,1350
"907","1903_27_TeamNH_TeamA3",92,5,2908174,2909174,1000
"908","1903_27_TeamNH_TeamA3",99,6,3038074,3039724,1650
"909","1903_27_TeamNH_TeamA3",126,6,3957724,3959224,1500
"910","1903_27_TeamNH_TeamA3",128,4,4117274,4117874,600
"911","1903_27_TeamNH_TeamA3",136,4,6839074,6840774,1700
"912","1903_27_TeamNH_TeamA3",143,5,7180624,7181974,1350
"913","1903_27_TeamNH_TeamA3",150,6,7340374,7341824,1450
"914","1903_27_TeamNH_TeamA3",236,4,10494674,10496074,1400
"915","1903_27_TeamNK_TeamB",3,6,92870,93893,1023
"916","1903_27_TeamNK_TeamB",102,4,3981198,3981924,726
"917","1903_27_TeamNK_TeamB",123,6,4657112,4657838,726
"918","1903_27_TeamNK_TeamB",135,4,5029913,5030606,693
"919","1903_27_TeamNK_TeamB",139,4,5216825,5217353,528
"920","1903_27_TeamNK_TeamB",247,6,9061730,9063083,1353
"921","1903_27_TeamNK_TeamB",273,4,10025925,10026783,858
"922","1903_28_TeamNF_TeamA2",110,6,3545951,3547001,1050
"923","1903_28_TeamNF_TeamA2",168,5,5713101,5714101,1000
"924","1903_28_TeamNF_TeamA2",196,6,6898351,6899751,1400
"925","1903_28_TeamNF_TeamA2",256,4,8913501,8914701,1200
"926","1903_29_TeamNF_TeamA2",24,5,616504,617204,700
"927","1903_29_TeamNF_TeamA2",31,4,934254,935204,950
"928","1903_29_TeamNF_TeamA2",60,5,1832054,1832854,800
"929","1903_29_TeamNF_TeamA2",67,5,2185529,2187529,2000
"930","1903_29_TeamNF_TeamA2",76,6,2492529,2494079,1550
"931","1903_29_TeamNF_TeamA2",102,4,3395029,3396279,1250
"932","1903_29_TeamNF_TeamA2",114,6,3805221,3806221,1000
"933","1903_29_TeamNF_TeamA2",130,4,4382921,4383821,900
"934","1903_29_TeamNF_TeamA2",143,5,4802971,4804771,1800
"935","1903_29_TeamNF_TeamA2",197,4,6619821,6620821,1000
"936","1903_29_TeamNF_TeamA2",211,4,7029871,7031371,1500
"937","1903_29_TeamNF_TeamA2",232,5,7824221,7825921,1700
"938","1903_29_TeamNF_TeamA2",235,5,8015971,8016521,550
"939","1903_29_TeamNF_TeamA2",254,4,8745671,8746971,1300
"940","1903_29_TeamNF_TeamA2",255,4,8891721,8892671,950
"941","1903_30_TeamNB_TeamA1",3,5,85884,87884,2000
"942","1903_30_TeamNB_TeamA1",22,4,609234,609984,750
"943","1903_30_TeamNB_TeamA1",29,4,832634,833534,900
"944","1903_30_TeamNB_TeamA1",61,4,1855784,1856634,850
"945","1903_30_TeamNB_TeamA1",64,6,1912584,1914134,1550
"946","1903_30_TeamNB_TeamA1",104,5,3319671,3320371,700
"947","1903_30_TeamNB_TeamA1",116,4,3672621,3674021,1400
"948","1903_30_TeamNB_TeamA1",138,5,4536121,4537471,1350
"949","1903_30_TeamNB_TeamA1",171,6,5662021,5662871,850
"950","1903_30_TeamNB_TeamA1",211,5,7332648,7333248,600
"951","1903_30_TeamNB_TeamA1",219,4,7476698,7477648,950
"952","1903_30_TeamNB_TeamA1",226,4,7776348,7777298,950
"953","1903_30_TeamNB_TeamA1",252,4,8628248,8628948,700
"954","1903_30_TeamNB_TeamA1",263,5,9002198,9003748,1550
"955","1903_30_TeamNB_TeamA1",268,4,9113098,9113948,850
"956","1903_30_TeamNF_TeamA2",1,6,16397,17297,900
"957","1903_30_TeamNF_TeamA2",30,5,767247,768047,800
"958","1903_30_TeamNF_TeamA2",32,6,832547,833647,1100
"959","1903_30_TeamNF_TeamA2",87,5,2424797,2425597,800
"960","1903_30_TeamNF_TeamA2",106,6,3163097,3164797,1700
"961","1903_30_TeamNF_TeamA2",113,5,3320147,3320847,700
"962","1903_30_TeamNF_TeamA2",131,6,3952847,3954047,1200
"963","1903_30_TeamNF_TeamA2",138,4,4203897,4204497,600
"964","1903_30_TeamNF_TeamA2",140,6,4261947,4262997,1050
"965","1903_30_TeamNF_TeamA2",147,5,4512747,4514047,1300
"966","1903_30_TeamNF_TeamA2",171,4,5372497,5373547,1050
"967","1903_30_TeamNF_TeamA2",193,5,6011647,6013247,1600
"968","1903_30_TeamNF_TeamA2",205,6,6458247,6459397,1150
"969","1903_30_TeamNF_TeamA2",207,6,6625547,6626997,1450
"970","1903_30_TeamNF_TeamA2",212,6,6759947,6761047,1100
"971","1903_30_TeamNF_TeamA2",259,5,8530197,8531397,1200
"972","1903_31_TeamNB_TeamA1",18,5,504742,505992,1250
"973","1903_31_TeamNB_TeamA1",53,6,1875288,1877338,2050
"974","1903_31_TeamNB_TeamA1",124,6,4348288,4349388,1100
"975","1903_31_TeamNB_TeamA1",132,6,4674138,4675388,1250
"976","1903_31_TeamNB_TeamA1",150,4,5204688,5205838,1150
"977","1903_31_TeamNB_TeamA1",221,5,7616238,7617438,1200
"978","1903_31_TeamNB_TeamA1",241,4,8393288,8394238,950
"979","1903_31_TeamNB_TeamA1",284,4,9923188,9925038,1850
"980","1903_31_TeamNB_TeamA1",290,4,10198638,10200188,1550
"981","1903_31_TeamNB_TeamA1",297,4,10356788,10357638,850
"982","1903_32_TeamNB_TeamA1",3,4,47938,48588,650
"983","1903_32_TeamNB_TeamA1",18,5,498288,499788,1500
"984","1903_32_TeamNB_TeamA1",39,5,1105038,1105988,950
"985","1903_32_TeamNB_TeamA1",42,6,1168138,1168988,850
"986","1903_32_TeamNB_TeamA1",54,4,1673138,1673888,750
"987","1903_32_TeamNB_TeamA1",58,6,1744938,1745688,750
"988","1903_32_TeamNB_TeamA1",74,5,2152038,2152888,850
"989","1903_32_TeamNB_TeamA1",76,5,2310238,2311288,1050
"990","1903_32_TeamNB_TeamA1",80,6,2574477,2575177,700
"991","1903_32_TeamNB_TeamA1",84,4,2652227,2653577,1350
"992","1903_32_TeamNB_TeamA1",132,5,4348927,4350527,1600
"993","1903_32_TeamNB_TeamA1",144,6,4757977,4758777,800
